United Nations	United Nations
Mechanism for International Criminal Tribunals	Mechanism for International Criminal Tribunals
Nations Unies	Nations Unies
Mécanisme pour les Tribunaux pénaux internationaux	Mécanisme pour les Tribunaux pénaux internationaux
STATEMENT	OBRAĆANJE
PRESIDENT	PREDSEDNIK
(Exclusively for the use of the media. Not an official document)	(Isključivo za medije. Nije zvaničan dokument.)
,The Hague,, Arusha,, 10 December 2014,	,Hag,, Aruša,, 10. decembar 2014.,
Address of Judge Theodor Meron	,Obraćanje sudije Theodora Merona,,,
President of the International Criminal Tribunal for the former Yugoslavia And	predsednika Međunarodnog krivičnog suda za bivšu Jugoslaviju
President of the International Residual Mechanism for Criminal	i predsednika Mehanizma za međunarodne krivične sudove
Tribunals to the United Nations Security Council 10 December 2014	Savetu bezbednosti Ujedinjenih nacija 10. decembra 2014.
,Mr. President,, Excellencies,, Ladies and Gentlemen:,	,Gospodine predsedniče,, ekselencije,, dame i gospodo:,
It is an honour to once again appear before this Council in two capacities: as President of the International	Čast mi je da se još jednom pojavim pred ovim Savetom u dvostrukom svojstvu: kao predsednik
Criminal Tribunal for the former Yugoslavia and as President of the Mechanism for International Criminal	Međunarodnog krivičnog suda za bivšu Jugoslaviju i kao predsednik Mehanizma za međunarodne krivične
Tribunals. I hope that my remarks today will serve to elucidate certain key points set forth in the recent reports	sudove. Nadam se da će moje današnje obraćanje poslužiti da se pojasne neke od ključnih stavki navedene u
submitted on behalf of these two institutions.	nedavnim izveštajima podnetim u ime ove dve institucije.
,However,, before I turn to these points,, I would like to congratulate His Excellency Ambassador Zene of Chad on,	,Međutim,, pre nego što se osvrnem na ta pitanja,, želeo bih da čestitam njegovoj ekselenciji ambasadoru Zeneu,
his country’s assumption of the Presidency of the Security Council. I also wish to express again my appreciation	iz Čada na tome što je njegova zemlja preuzela funkciju predsedavajućeg Saveta bezbednosti. Takođe bih želeo
,for the efforts of the Security Council’s informal working group on international tribunals,, and,, particularly,,,	da naglasim svoju zahvalnost na naporima neformalne Radne grupe Saveta bezbednosti za međunarodne
Chile for its leadership of that group. And I continue to be extremely grateful for the extensive support that the	,sudove,, i posebno,, Čileu na rukovođenju tom grupom. Takođe sam i dalje izuzetno zahvalan na velikoj podršci,
Office of Legal Affairs and the Legal Counsel provide to the ICTY and the Mechanism.	koju MKSJ i Mehanizmu pružaju Služba pravnog savetnika UN i sam pravni savetnik.
I will first turn to the ICTY. I am pleased to report that the Tribunal continues to make progress in completing	Prvo ću se osvrnuti na MKSJ. Zadovoljstvo mi je da vas mogu obavestiti da Međunarodni sud nastavlja da
	,ostvaruje napredak u završavanju svojih poslednjih prvostepenih i drugostepenih postupaka. Štaviše,, tokom,
,its last trials and appeals. Indeed,, we have already delivered two appeal judgements in 2014,, and expect to,	,2014. smo već izrekli dve presude po žalbama,, i očekujemo izricanje još jedne do kraja januara 2015,, u,
,deliver another one—in the large,, multi-accused Popović case—by the end of January 2015. Accordingly,, we,	,velikom predmetu Popović i drugi,, sa više optuženih. Shodno tome,, ulazimo u 2015. godinu sa preostala samo,
enter 2015 with only four trials and five appeal cases remaining. By the end of next year judgements in only	četiri prvostepena postupka i pet drugostepenih. Do kraja sledeće godine preostaće da se izreknu presude u
,two cases—specifically,, one trial and one appeal—should remain outstanding.,	,samo dva predmeta,, konkretno,, jednom u prvostepenom i jednom u žalbenom postupku.,
,www.unmict.org As our November report makes plain,, and as Council members have been aware for several years,, despite the,	,Kao što je navedeno u našem izveštaju iz novembra,, i kao što članovi Saveta znaju već nekoliko godina,, uprkos,
,significant progress we have made in finishing cases,, the Tribunal will not be able to complete all of its judicial,	,značajnom napretku ostvarenom u okončanju predmeta,, Međunarodni sud neće biti u stanju da završi sav svoj,
,work by the end of this month. Numerous unforeseen and sometimes challenging circumstances,, including the,	,pravosudni rad do kraja ovog meseca. Brojne nepredviđene i ponekad veoma otežavajuće okolnosti,, poput,
,late arrests of the last ICTY indictees,, the disqualification of a Judge,, the health conditions of a number of our,	,zakasnelog hapšenja poslednjih optuženih pred MKSJ,, izuzeća jednog sudije,, zdravstvenog stanja više,
,accused,, and the size and complexity of certain multi-accused cases,, have prevented us from meeting the,	,optuženih,, kao i obima i kompleksnosti određenih predmeta sa više optuženih,, sprečile su nas da ispunimo rok,
Security Council’s target date for completion of our judicial work by the end of 2014.	koji nam je zadao Savet bezbednosti da završimo svoj pravosudni rad do kraja 2014. godine.
,Although the majority of our remaining cases are progressing in line with previous forecasts,, our November,	,Premda se u većini preostalih predmeta ostvaruje napredak u skladu s našim prethodnim procenama,, u našem,
report also explains that certain trial and appeal judgements will be later than forecast by the Tribunal in May.	izveštaju iz novembra takođe je objašnjeno da će određene prvostepene i drugostepene presude biti izrečene
	kasnije nego što je to Međunarodni sud predvideo u maju. Činjenica da dolazi do takvih odlaganja
,The fact that such delays occur is disappointing to me and to my fellow Judges. Importantly,, however,, these,	,razočaravajuća je za mene i moje kolege sudije. Međutim,, ono što je važno jeste da te nedavne izmene u,
recent changes to our judgement schedule are not expected to impact the anticipated date of the Tribunal’s	,rasporedu izricanja presuda neće uticati na predviđeni rok zatvaranja Međunarodnog suda,, tokom 2017.,
,closure,, in 2017.,	godine.
,I would further note,, as I have before,, that the judicial process is inherently dynamic and mutable; it is a,	,Dodatno bih napomenuo,, kao što sam to i ranije činio,, da je pravosudni proces inherentno dinamičan i podložan,
,process that takes place against a background of great legal and logistical complexity,, and may be affected by,	,promenama. To je proces koji se odvija u kontekstu velike pravne i logističke kompleksnosti,, i na njega mogu,
,any matter of unforeseen developments,, such as the discovery of mass graves with possible forensic,	,uticati mnogobrojne nepredvidljive okolnosti,, poput otkrića masovnih grobnica od mogućeg forenzičkog,
,significance. In this context,, forecasts for the completion of the Tribunal’s judicial work are inevitably subject to,	,značaja. U tom kontekstu,, predviđanja u vezi sa okončanjem pravosudnog rada Međunarodnog suda su,
revision. I can assure the Council that the Judges and staff of the Tribunal nevertheless remain focused on	,neizbežno podložna izmenama. Uveravam Savet da su sudije i osoblje,, uprkos svemu,, i dalje usresređeni na to,
doing all that they can to avoid or reduce delays. The Tribunal also remains fully committed to transparency:	da učine sve što je u njihovoj moći da se odlaganja izbegnu ili smanje. Međunarodni sud ostaje i dalje u
,when we know about changes to forecasts for a case schedule,, we always communicate that information in our,	potpunosti posvećen transparentnosti: kada znamo da će doći do izmene u predviđanjima u vezi sa rasporedom
reports.	,nekog predmeta,, tu informaciju uvek dostavljamo u svojim izveštajima.,
There are two specific issues to which I wish to draw the attention of the Council.	Postoje dva konkretna pitanja na koja želim da ukažem Savetu.
,The first involves the health condition of several of our detainees,, which has impacted two of our trials and,	,Prvo se odnosi na zdravstveno stanje više naših pritvorenika,, koje je imalo uticaja na dva suđenja,, i predstavlja,
,which is a matter of great concern to the Tribunal and to me personally. As detailed in the November report,,,	,pitanje koje izaziva veliku zabrinutost na Međunarodnom sudu,, i moju lično. Kao što je detaljno navedeno u,
the trial of Mr. Goran Hadžić has been temporarily adjourned since 20 October 2014 for reasons relating to	,našem izveštaju iz novembra,, suđenje Goranu Hadžiću je privremeno prekinuto od 20. oktobra 2014. iz,
,Mr. Hadžić’s health. In addition,, the trial of Mr. Ratko Mladić has been reduced to four sitting-days per week,,,	,razloga povezanih s Hadžićevim zdravstvenim stanjem. Osim toga,, suđenje Ratku Mladiću je takođe skraćeno,
,following medical advice. At this time,, the Hadžić Chamber does not believe the adjournment will impact on the,	,na četiri dana suđenja sedmično,, u skladu sa savetima lekara. Pretresno veće koje postupa u predmetu Hadžić,
,scheduled judgement delivery date. By contrast,, the changes in the sitting schedule of the Mladić Chamber,,,	www.unmict.orgu ovom trenutku ne veruje da će ovo odlaganje imati posledice na predviđeni rok izricanja presude. Nasuprot
,along with the recent decision to re-open the Prosecution case,, mean that the judgement in that trial is delayed,	,tome,, izmene u rasporedu vođenja pretresa u predmetu Mladić,, zajedno s nedavnom odlukom da se ponovo,
	,otvori dokazni postupak Tužilaštva,, znače da je izricanje presude u tom predmetu odgođeno do marta 2017.,
,until March 2017 or later. Finally,, Mr. Vojislav Šešelj—whose trial was delayed by the disqualification of a Judge,	,godine ili kasnije. Na kraju,, Vojislavu Šešelju,, čije suđenje je odgođeno zbog izuzeća jednog sudije 2013.,
,in 2013—has been granted provisional release by the Trial Chamber considering his case,, a course of action the,	,godine,, Pretresno veće je odobrilo privremeno puštanje na slobodu,, što je korak koji je Pretresno veće smatralo,
Chamber deemed appropriate in light of developments concerning Mr. Šešelj’s health.	prikladnim imajući u vidu razvoj događaja u vezi sa zdravstvenim stanjem Vojislava Šešelja.
,www.unmict.org Due to the age of our detainees,, health-related issues are an unavoidable concern and raise humanitarian,	,Zbog starosti naših pritvorenika,, pitanja u vezi sa zdravstvenim stanjem su neizbežna briga i sa sobom povlače,
,questions. Although the Tribunal makes every effort to ensure appropriate medical care,, developments related,	pitanja humanitarne prirode. Iako Međunarodni sud ulaže sve moguće napore da obezbedi odgovarajuću
,to the health of detainees can sometimes fall outside our control and,, as I am sure the Council understands,,,	,zdravstvenu negu,, razvoj događaja u vezi sa zdravstvenim stanjem optuženih nekada ostaje izvan naše,
can cause delays to the Tribunal’s work.	,kontrole,, i,, kao što sam siguran da Savet razume,, može dovesti do odlaganja u radu Međunarodnog suda.,
,The second matter I would like to address is staff recruitment and retention. This issue,, which is discussed in,	,Drugo pitanje koje bih želeo da pomenem jeste zapošljavanje i zadržavanje zaposlenih. Ovo pitanje,, o kojem je,
,my November report,, also has the potential to adversely affect our judgement delivery schedule. As the,	,bilo reči u mom izveštaju iz novembra,, takođe potencijalno može imati negativan uticaj na raspored izricanja,
,members of this Council are aware,, the Tribunal is significantly reducing in size over this budget biennium and,	,presuda. Kao što su članovi Saveta svesni,, Međunarodni sud se značajno smanjuje tokom ovog dvogodišnjeg,
by the end of next year is expected to have drastically cut its staffing levels. This downsizing is inevitable—but	budžetskog ciklusa i do kraja sledeće godine se očekuje da će drastično smanjiti broj svog osoblja. Ovo
	,smanjivanje broja zaposlenih je neminovno,, ali ono takođe dovodi do izazova u smislu održavanja,
also gives rise to challenges when it comes to maintaining appropriate staffing levels. Despite staff members’	odgovarajućeg broja zaposlenih. Uprkos tome što su zaposleni posvećeni radu na svojim predmetima i
,dedication to their cases and duties,, many of them are searching for other employment—and where offers,	,obavljanju svojih dužnosti,, mnogi od njih traže drugo zaposlenje,, i u slučajevima ponuda koje se ne mogu,
,cannot be deferred,, they are leaving the Tribunal,, depriving us of valuable institutional and case-specific,	,odgoditi,, oni napuštaju Međunarodni sud,, ostavljajući nas bez dragocenog institucionalnog znanja i znanja o,
knowledge.	konkretnim predmetima.
,Unable to deploy the most effective staff retention strategies,, such as the incentive bonuses unfortunately,	,U nemogućnosti da primenimo najdelotvornije strategije za zadržavanje zaposlenih,, poput podsticaja u vidu,
,rejected by the General Assembly,, the Tribunal is attempting to retain and,, where necessary,, replace staff,	,bonusa,, koje je Generalna skupština nažalost odbacila,, Međunarodni sud pokušava da zadrži,, i gde je to,
members in the most efficient manner possible. The three Principals of the Tribunal are most grateful to the	,potrebno,, zameni zaposlene na najefikasniji mogući način. Trojica čelnih ljudi Međunarodnog suda su veoma,
Office of Human Resources Management for measures taken to support the Tribunal in this respect.	zahvalna Službi Ujedinjenih nacija za rukovođenje ljudskim resursima na merama koje je preduzela kako bi podržala Međunarodni sud u tom smislu.
,By design,, my reports to you on the Tribunal focus almost exclusively on procedural issues and requests for,	,Po samoj svojoj prirodi,, izveštaji koje vam podnosim u vezi s Međunarodnim sudom usredsređeni su gotovo,
,assistance in completing our work. I very much hope,, however,, that the nature of these briefings will not lead,	,isključivo na proceduralna pitanja i zahteve za pomoć kako bismo okončali naš rad. Ja,, međutim,, gajim veliku,
,any of us to forget the bigger picture and the tremendously significant role that the ICTY has played,, and,	nadu da priroda ovih izveštaja neće dovesti do toga da se zaboravi širi kontekst izuzetno značajne uloge koju je
,continues to play,, both in setting global standards for international criminal law and justice and in helping to,	,imao,, i koju i dalje ima,, MKSJ,, kako u postavljanju globalnih standarda u međunarodnom krivičnom pravu i,
,strengthen the rule of law at the local level. Indeed,, just last month I travelled for several days in Bosnia and,	,pravosuđu,, tako i u pomaganju učvršćivanja vladavine prava na lokalnom nivou. Prošlog meseca sam nekoliko,
,Herzegovina,, meeting with representatives of diverse communities there and paying my respects at sites where,	,dana boravio u Bosni i Hercegovini,, gde sam se sastao s predstavnicima tamošnjih različitih zajednica i odao,
,terrible crimes have been found to have taken place. Our discussions underscored that the ICTY has made,, and,	poštu žrtvama na mestima gde je utvrđeno da su počinjeni užasni zločini. U razgovorima koje smo vodili
,continues to make,, an invaluable contribution to the restoration of the rule of law in the former Yugoslavia.,	,naglašeno je da je MKSJ dao,, i da nastavlja da daje,, neprocenjiv doprinos obnavljanju vladavine prava na,
,Given the importance of the Tribunal’s work,, I would urge the Council to approve the full extensions of Judges’,	,području bivše Jugoslavije. S obzirom na važnost rada Međunarodnog suda,, apelujem na Savet da u celosti odobri produženja mandata,
terms requested in my letters of 1 October and 25 November. The precedents set by the Tribunal and by its	sudijama koja sam zatražio u svojim pismima od 1. oktobra i 25. novembra. Presedani koje je postavio
accounting for all of the 161 individuals it has indicted have been instrumental in inaugurating a new era of	,Međunarodni sud,, uključujući i činjenicu da je locirao svaku od 161 osobe protiv kojih je podigao optužnicu,,,
accountability. It is essential that the international community continue to support us in this endeavour and one	postavili su temelje nove epohe pozivanja na odgovornost. Od presudne je važnosti da međunarodna zajednica
of the best ways to do this is by granting the extensions needed to complete our few remaining cases. www.unmict.org	nastavi da nam pruža podršku u ovim nastojanjima i jedan od najboljih načina da to učini je da odobri
,I will now turn to the Mechanism. In creating the Mechanism,, the Security Council not only tasked the new,	produženja mandata potrebna da bi se završila nekolicina preostalih predmeta.
	,Sada ću se osvrnuti na Mehanizam. Kada je osnovao Mehanizam,, Savet bezbednosti ovoj novoj instituciji nije,
,institution with responsibility for certain essential functions of the ICTR and the ICTY. This Council also,, in,	samo dao zadatak da preuzme odgovornost za neke od ključnih funkcija MKSR i MKSJ. Savet bezbednosti je
,essence,, challenged the Mechanism to serve as an example of best practices and to learn from the experience,	,takođe,, u suštini,, postavio izazov Mehanizmu da služi kao primer najbolje prakse i da uči iz iskustva drugih,
,of other international tribunals in order to operate in the most lean and efficient manner possible,, while,	,međunarodnih sudova kako bi funkcionisao na najefikasniji mogući način sa što manjim brojem zaposlenih,,,
,respecting relevant procedural safeguards. I am pleased to confirm that by almost any measure,, the,	,poštujući pri tome relevantne proceduralne mehanizme zaštite. Zadovoljstvo mi je da mogu da potvrdim da,, u,
Mechanism is meeting all of these important aims.	,gotovo svim aspektima,, Mehanizam ispunjava sve ove važne ciljeve.,
,The Mechanism continues to make steady progress in carrying out its judicial work and later this month,, in line,	Mehanizam nastavlja da ostvaruje kontinuiran napredak u obavljanju svojih pravosudnih funkcija i kasnije
,with previous forecasts,, I will be travelling to Arusha to deliver the Mechanism’s very first appeal judgement.,	,tokom ovog meseca,, u skladu s prethodnim predviđanjima,, otputovaću u Arušu,, na izricanje prve drugostepene,
,Mechanism Judges in Arusha and The Hague have also been busy deciding a wide variety of motions,, involving,	presude Mehanizma. Sudije Mehanizma u Aruši i Hagu su takođe veoma zauzeti rešavanjem po raznim
issues such as variations to confidentiality protections and cooperation with national jurisdictions.	zahtevima koji se odnose na pitanja poput izmene zaštitnih mera o poverljivosti i saradnje s nacionalnim
	pravosudnim sistemima.
The Mechanism stands ready to adjudicate any appeals from the four trials ongoing at the ICTY. At the same	Mehanizam je spreman da presuđuje po eventualnim žalbama proisteklim iz aktuelnih predmeta pred MKSJ. U
,time,, different sections of the Mechanism are preparing rosters to allow rapid staff recruitment and are,	,isto vreme,, različite službe Mehanizma pripremaju spiskove koji će omogućiti brzo zapošljavanje osoblja i,
undertaking other measures to ensure readiness in case any of the three remaining ICTR fugitive indictees	preduzimaju druge mere kako bi se obezbedila spremnost u slučaju da bilo koji od trojice preostalih optuženih
whose cases have not been referred to Rwanda are arrested.	pred MKSR čiji predmeti nisu prosleđeni Ruandi bude uhapšen.
,As set forth in my written report,, responsibility for a wide variety of functions—including witness protection,,,	,Kao što je navedeno u mom pisanom izveštaju,, odgovornost za širok spektar funkcija,, među kojima su zaštita,
,enforcement of sentences,, monitoring of referred cases,, and preservation of archives—has been transferred or,	,svedoka,, sprovođenje kazni,, nadgledanje prosleđenih predmeta i očuvanje arhiva,, prenosi se ili je prenesena na,
,is being transferred to the Mechanism. Concurrently,, the Mechanism is increasingly assuming direct,	,Mehanizam. Istovremeno,, Mehanizam sve više preuzima direktnu odgovornost za administrativne funkcije,,,
responsibility for administrative functions like Human Resources.	poput ljudskih resursa.
The Mechanism continues to engage with Rwanda and the States of the former Yugoslavia as well as with our	,www.unmict.orgMehanizam nastavlja da sarađuje s Ruandom i državama nastalim na području bivše Jugoslavije,, kao i s našim,
,host states,, Tanzania and The Netherlands. A host state agreement has already been signed with Tanzania,,,	,zemljama domaćinima,, Tanzanijom i Holandijom. Sporazum sa zemljom domaćinom već je potpisan sa,
,while a text with The Netherlands has been initialled. In Arusha,, we are moving towards commencing,	,Tanzanijom,, dok je tekst sporazuma s Holandijom parafiran. U Aruši se približavamo početku izgradnje novog,
,construction of the new premises authorized by the General Assembly,, and we are continuing discussions with,	,objekta koji je odobrila Generalna skupština,, a nastavljamo razgovore s Holandijom u vezi s budućim sedištem,
,The Netherlands concerning the future facility of the Mechanism. Relying on outside funding,, we are also,	,Mehanizma. Oslanjajući se na spoljno finansiranje,, takođe pokrećemo ograničene programe koji imaju za cilj da,
	se podeli znanje s pravnim fakultetima i pravosuđem u Tanzaniji.
launching limited programs aimed at knowledge sharing with Tanzanian law schools and members of the	Mehanizam se i dalje suočava s dva ključna izazova. Prvi je što i dalje nisu izvršeni nalozi za hapšenje
judiciary. Two key challenges continue to face the Mechanism. The first is the outstanding arrest warrants for the	,preostalih optuženih pred MKSR koji su i dalje u bekstvu,, među kojima su i trojica kojima treba da se sudi pred,
,remaining ICTR indictees who have yet to be apprehended,, including three who are expected to be tried by the,	Mehanizmom. Od presudne je važnosti da ovi optuženi u bekstvu budu uhapšeni. Isto kao što je lociranje svih
Mechanism. It is imperative that these fugitives be apprehended; just as the accounting for all ICTY indictees	,optuženih pred MKSJ zadalo važan udarac nekažnjivosti,, tako će i lociranje svih optuženih pred MKSR dati,
,struck an important blow against impunity,, so too a full accounting of ICTR indictees will provide confirmation,	,potvrdu privrženosti međunarodne zajednice pravdi i pozivanju na odgovornost. Shodno tome,, apelujem na,
,www.unmict.org of the international community’s commitment to justice and accountability. Accordingly,, I urge this Council to,	Savet bezbednosti da ponovi svoj poziv svim državama članicama da sarađuju u naporima na hapšenju
renew its call to all Member States to cooperate with efforts to arrest the remaining fugitives indicted by the	preostalih optuženih pred MKSR koji su u bekstvu.
ICTR. A second challenge facing the Mechanism is posed by the persons acquitted by the ICTR and the release of	Drugi izazov s kojim se Mehanizam suočava jesu osobe koje je MKSR oslobodio krivice i puštanje na slobodu
individuals who have completed sentences imposed by the ICTR. The Mechanism will assume responsibility for	osoba koje su izdržale kazne koje im je izrekao MKSR. Mehanizam će preuzeti nadležnost nad svim takvim
,all such individuals released in Tanzania on 1 January 2015,, having already assumed other relocation-related,	,osobama koje se puštaju na slobodu u Tanzaniji 1. januara 2015,, nakon što je već preuzeo druge funkcije u,
functions. I consider the question of resettlement to be a crucial matter of humanitarian concern for the	vezi s relokacijom. Smatram pitanje preseljenja jednim od ključnih pitanja od humanitarnog značaja za
,international community. These individuals,, having been exonerated or served the sentences imposed by the,	,međunarodnu zajednicu. Ove osobe,, koje su oslobođene krivice ili su odslužile kazne koje im je izrekao MKSR,,,
,ICTR,, deserve the opportunity to be resettled and to rebuild their lives. The total number of these acquitted and,	zaslužuju priliku da budu preseljene i da ponovo izgrade svoje živote. Ukupan broj ovih osoba koje su
released individuals is very small and just a few States stepping forward to give them shelter could address the	,oslobođene krivice ili su puštene na slobodu veoma je mali,, i ako bi svega nekoliko država izrazilo spremnost da,
problem.	,im pruži utočište,, to bi rešilo ovaj problem.,
,These challenges to the Mechanism are real. They should not,, however,, obscure the real progress achieved in,	,Izazovi s kojima se Mehanizam suočava su stvarni. Oni,, međutim,, ne bi trebalo da prikriju stvarni napredak,
launching both branches of the Mechanism and smoothly transitioning responsibilities according to the timelines	ostvaren u pokretanju rada oba ogranka Mehanizma i neometanom prebacivanju nadležnosti u skladu s
,mandated by the Security Council. The Principals and staff of the Mechanism,, and of the ICTR and the ICTY,,,	,rokovima koje je zacrtao Savet bezbednosti. Čelni ljudi Mehanizma,, kao i MKSR i MKSJ,, zaslužuju svaku,
should be applauded for their efforts in making all of this possible.	pohvalu za napore uložene kako bi se sve to omogućilo.
,Mr. President,, Excellencies,, despite the challenges that both the ICTY and the Mechanism face and that I have,	,Gospodine predsedniče,, ekselencije,, uprkos izazova s kojima se suočavaju i MKSJ i Mehanizam,, koje sam,
,highlighted in my briefing today,, the world is unquestionably a better place because of them. This is not simply,	,naglasio u svom današnjem obraćanju,, svet je nesumnjivo bolje mesto zahvaljujući radu obe ove institucije. To,
,because of their adjudication of specific cases but also because of the long shadow international courts cast,,,	,nije samo zbog toga što presuđuju u konkretnim predmetima,, već i zbog dugačke senke koju bacaju,
promoting more lawful behaviour by States and individuals. With the support and encouragement of the	,međunarodni sudovi,, što doprinosi tome da se države i pojedinci više pridržavaju zakona. Uz podršku i podsticaj,
,Member States of the United Nations,, the ICTY,, the Mechanism,, and other international tribunals have served,	,država članica Ujedinjenih nacija,, MKSJ,, Mehanizam i drugi međunarodni sudovi su služili i nastavljaju da služe,
and continue to serve as the concrete manifestation of a commitment to ending impunity and a testament to	kao konkretan primer privrženosti okončanju nekažnjivosti i kao svedočanstvo posvećenosti međunarodne
the international community’s dedication to creating a world where the rule of law is supreme.	zajednice stvaranju sveta u kojem je vladavina prava neprikosnovena. 
Thank you.	Hvala vam.
www.unmict.org	www.unmict.org
MICT	MMKS
UNITED NATIONS	UJEDINJENE NACIJE 
Mechanism for International Criminal Tribunals	Mehanizam za međunarodne krivične sudove 
The Mechanism for International Criminal Tribunals (“MICT” or “Mechanism”) was established on 22 December 2010 by the United Nations	Mehanizam za međunarodne krivične sudove (MMKS ili Mehanizam) osnovao je Savjet bezbjednosti Ujedinjenih nacija 22. decembra 2010.
,Security Council to continue the jurisdiction,, rights,, obligations and essential functions of the International Criminal Tribunal for Rwanda,	,da nastavi nadležnosti,, prava,, obaveze i ključne funkcije Međunarodnog krivičnog suda za Ruandu (MKSR) i Međunarodnog krivičnog suda,
(“ICTR”) and the International Criminal Tribunal for the former Yugoslavia (“ICTY”) after the completion of their respective mandates.	,za bivšu Jugoslaviju (MKSJ) nakon okončanja njihovih mandata. MMKS ima dva ogranka,, jedan u Arushi,, Tanzanija,, i drugi u Haagu,,,
,The MICT has two branches,, one in Arusha,, Tanzania,, and one in The Hague,, Netherlands.,	
STATEMENT	Nizozemska.
PRESIDENT	OBRAĆANJE
(Exclusively for the use of the media. Not an official document)	PREDSEDNIK (Isključivo za medije. Nije zvaničan dokument.)
,Arusha,, The Hague,, 9 November 2016,	,Arusha,, Hag,, 9. novembar 2016.,
Address to the UN General Assembly Judge Theodor Meron	,Obraćanje sudije Theodora Merona,, predsednika Mehanizma za,
,President,, Mechanism for International Criminal Tribunals,	međunarodne sudove Generalnoj skupštini Ujedinjenih nacija
9 November 2016	9. novembar 2016.
,Mr. President,, Excellencies,, Ladies and Gentlemen:,	,Gospodine predsedniče,, ekselencije,, dame i gospodo:,
It is my privilege to appear before the General Assembly once again in my capacity as President of the	Privilegija mi je da se još jednom pojavim pred Generalnom skupštinom u svojstvu predsednika
Mechanism for International Criminal Tribunals.	Mehanizma za međunarodne krivične sudove.
,Before I turn to the substance of my remarks,, I wish to take this opportunity to congratulate you,, Mr.,	,Pre nego što se osvrnem na pojedinosti svog izveštaja,, želeo bih da iskoristim ovu priliku da Vam,
,President,, on Fiji’s assumption of the General Assembly Presidency and to wish you every success,	,čestitam,, gospodine predsedniče,, na tome što je Fidži preuzeo predsedavanje Generalnom skupštinom,
during your term. I also wish to acknowledge the steadfast support and assistance provided by the	i da Vam poželim puno uspeha tokom Vašeg mandata. Takođe bih želeo da zahvalim na
,Office of Legal Affairs and,, in particular,, by Mr. Miguel de Serpa Soares,, the Under-Secretary-General,	nepokolebljivoj pomoći i podršci koju nam pruža Služba za pravne poslove Ujedinjenih nacija i sam
,for Legal Affairs and United Nations Legal Counsel,, as well as by Mr. Stephen Mathias,, the Assistant,	,pravni savetnik,, g. Miguel de Serpa Soares,, kao i pomoćnik generalnog sekretara Ujedinjenih nacija za,
Secretary-General for Legal Affairs.	,pravne poslove,, g. Stephen Mathias.,
,Last,, but certainly not least,, I would like to acknowledge with pleasure my fellow Judge at both the,	,Na kraju,, ali svako ne i kao poslednje,, želeo bih da sa zadovoljstvom zahvalim svom kolegi sudiji,, kako,
,Mechanism and the ICTY,, President Agius.,	,na Mehanizmu,, tako i u MKSJ,, predsedniku Agiusu.,
Mechanism for International Criminal Tribunals	Mehanizam za međunarodne krivične sudove
Tel: +31 70 512 5691 Email: mict-press@un.org	Tel: +31 70 512 5691 Email: mict-press@un.org
,Follow us on Facebook,, Twitter,, YouTube,, LinkedIn,	,Pratite MMKS na Facebook,, Twitter,, YouTube,, LinkedIn,
,Mr. President,, Excellencies,, as many of you know,, this year,, 2016,, marks the 400th anniversary of,	,www.unmict.org Gospodine predsedniče,, ekselencije,, kao što mnogi od vas znaju,, ove godine,, 2016,, obeležava se 400.,
William Shakespeare’s death.	Godišnjica smrti Viljema Šekspira.
,His fellow poet and playwright,, Ben Jonson,, wisely and correctly anticipated in 1623 that Shakespeare,	,Njegov kolega pesnik i dramski pisac,, Ben Džonson,, mudro je i ispravno 1623. godine anticipirao da,
,was “not of an age,, but for all time”. Yet,, it is to my deep dismay that Shakespeare’s depictions of,	,Šekspir “ne pripada svom dobu već je za sva vremena”. Pa ipak,, s velikim žaljenjem konstatujem da,
,the ravages of war remain equally relevant today,, some four hundred years after he wrote them. War,,,	,su Šekspirovi opisi strahota rata jednako relevantni danas,, više od četiri stotina godina nakon što ih je,
,in Shakespeare’s words,, is the “son of hell” (2 Henry the Sixth); it is “fierce and bloody” (King John),	,napisao. Rat je,, Šekspirovim rečima,,“sin pakla” (Drugi deo Henrija VI); on je “ strašan i krvav” (Kralj,
and “cruel” (Timon of Athens). Troilus and Cressida gives us a gruelling account of the senseless	Džon) i “svirep” (Timon Atinjanin). Troil i Kresida nam donose užasavajući opis besmislenog pokolja u
,slaughter of war,, while Hamlet offers the most powerful statement of the futility of war in a speech,	,ratu,, dok nam Hamlet nudi najupečatljiviju izjavu o ispraznosti rata u govoru protiv žrtvovanja hiljada,
,against sacrificing thousands of lives for trivial causes,, for “a fantasy and trick of fame”.,	,života zbog trivijalnih razloga,, za “jednu ćud,, za senku slave”.,
While much has not changed when it comes to conflict and bloodshed in the course of four hundred	,Iako se tokom ovih četiri stotine godina mnogo toga nije promenilo kada su u pitanju rat i krvoproliće,,,
,years,, at least one important thing has. During the past quarter century,, the international community,	,barem jedna stvar jeste. Tokom poslednjih četvrt veka,, međunarodna zajednica se ujedinila kao,
has come together as never before in an effort to end impunity for grave violations of international	nikada do sada u nastojanjima da okonča nekažnjivost za teške povrede međunarodnog prava i da
law and to promote respect for the rule of law—or what Shakespeare refers to as “the majesty and	,promoviše poštovanje vladavine prava,, ili ono što Šekspir naziva “značajem zakona i pravde”,, na šta,
,power of law and justice”,, which the Chief Justice of England invokes in explaining to the new King,	se vrhovni sudija Engleske poziva kada novoizabranom kralju Henriju V objašnjava da se i on sam mora
Henry V that even he had to submit to justice for infractions he had committed as Prince Hal (2 Henry	povinovati pravdi za grehe koje je počinio kao princ Hal (Drugi deo Henrija IV).
IV). By establishing the International Criminal Tribunal for the former Yugoslavia and the International	Osnivanjem Međunarodno krivičnog suda za bivšu Jugoslaviju i Međunarodnog krivičnog suda za Ruandu
,Criminal Tribunal for Rwanda in the early 1990s,, and the other international and hybrid criminal,	,početkom devedesetih godina XX veka,, kao i niza drugih međunarodnih i hibridnih krivičnih sudova koji,
,courts that would follow thereafter,, the international community has made manifest its commitment,	,su usledili,, međunarodna zajednica je dokazala svoju privrženost pravdi i principu individualne,
,to justice and to the principle of individual criminal responsibility. In doing so,, the international,	krivične odgovornosti. Na taj način međunarodna zajednica je pomogla da dođemo do onoga što je
community has helped to bring about the dawn of what Secretary-General Ban Ki-moon has described	generalni sekretar Ban Ki-moon opisao kao novu eru pozivanja na odgovornost.
as a new age of accountability.	
,The Mechanism is very much a part of this global effort to ensure accountability,, for by establishing,	,Mehanizam je u velikoj meri deo tih globalnih napora da se obezbedi pozivanje na odgovornost,, jer je,
,the Mechanism,, the UN Security Council was making certain that the closure of the ICTR and the ICTY,	osnivanjem Mehanizma Savet bezbednosti Ujedinjenih nacija obezbedio da zatvaranje MKSR i MKSJ ne
would not open the way for impunity to re-emerge and recognizing that justice and the rule of law	otvori put ponovnom povratku nekažnjivosti i prepoznao da pravda i vladavina prava zahtevaju
require a sustained commitment and support even after trials and appeals have concluded.	istrajnu privrženost i podršku čak i kada su suđenja i žalbe okončani.
,As detailed in the written report submitted on behalf of the Mechanism in August,, much has transpired,	,Kao što je detaljno navedeno u pisanom izveštaju koji je u ime Mehanizma dostavljen u avgustu,,,
,in the year since I last appeared before this Assembly. On the judicial front,, following the issuance of,	mnogo toga se dogodilo u poslednjih godinu dana od kada sam govorio pred ovom Skupštinom. Na
,ICTY judgements in December 2015 and March 2016,, the Mechanism is seised of a retrial in the case of,	,pravosudnom planu,, nakon izricanja presuda MKSJ u decembru 2015. i martu 2016. godine,, Mehanizam,
Stanišić & Simatović and appeals in the cases of Radovan Karadžić and Vojislav Šešelj. A wide variety	u svojoj nadležnosti ima ponovljeno suđenje u predmetu Stanišić i Simatović i žalbe u postupcima
of other requests and applications are regularly filed before the Mechanism and addressed by the	protiv Radovana Karadžića i Vojislava Šešelja. Niz drugih zahteva i molbi se redovno podnosi sudijama
,Mechanism’s Judges,, the majority of whom are—consistent with the Security Council’s vision of the,	,Mehanizma,, od kojih većina,, u skladu s vizijom Saveta bezbednosti o Mehanizmu kao maloj i efikasnoj,
Mechanism as a small and efficient institution—working remotely and part-time from their homes and	,instituciji,, rade na daljinu ili po potrebi iz svojih domova i kancelarija širom sveta,, obavljajući svoje,
,offices around the world,, carrying out their functions for the Mechanism on top of their other,	funkcije u Mehanizmu povrh svojih drugih profesionalnih obaveza. Od svog osnivanja Mehanizam je
,professional commitments. Since its establishment,, the Mechanism has issued in excess of 800 judicial,	izdao više od 800 sudskih naloga i odluka.
,orders and decisions. With the closure of the ICTR in December 2015,, the Mechanism has assumed responsibility for all,	,Po zatvaranju MKSR u decembru 2015. godine,, Mehanizam je preuzeo nadležnost nad svim preostalim,
remaining functions of that Tribunal and preparations for the transfer of relevant remaining ICTY	,funkcijama tog međunarodnog suda,, dok pripreme za prenos svih preostalih relevantnih funkcija MKSJ,
,functions continue,, in anticipation of that Tribunal’s expected closure at the end of 2017.,	,i dalje teku,, u očekivanju predviđenog zatvaranja tog međunarodnog suda krajem 2017. godine.,
,Throughout the reporting period,, essential ongoing functions—such as the protection of vulnerable,	,Tokom perioda na koji se izveštaj odnosi,, ključne tekuće funkcije,, poput zaštite osetljivih žrtava i,
,victims and witnesses,, the provision of assistance to national jurisdictions seeking to ensure,	,svedoka,, pružanja pomoći nacionalnim pravosudnim sistemima kako bi se obezbedilo pozivanje na,
,accountability in local proceedings,, and the supervision of the enforcement of sentences—have also,	,odgovornost u postupcima na nacionalnom nivou,, kao i nadgledanja izvršenja kazni,, i dalje se,
continued to be carried out with care and professionalism. Important steps have likewise been taken	obavljaju s velikom pažnjom i profesionalizmom. Takođe su preduzeti važni koraci u vezi s očuvanjem
with regard to the management and preservation of the vital archives of the ICTR and the ICTY entrusted to the Mechanism.	ključnih arhiva MKSR i MKSJ koji su povereni Mehanizmu i upravljanjem njima.
It is thanks in great part to the sustained cooperation and generosity of the Government of the United	Zahvaljujući velikim delom kontinuiranoj saradnji i velikodušnosti Vlade Ujedinjene Republike
,Republic of Tanzania that we will,, in under three weeks from today,, mark the opening of the,	,Tanzanije,, za manje od tri sedmice od današnjeg dana obeležićemo otvaranje novog objekta,
,Mechanism’s new premises in Arusha. This construction project,, which reflects a lean and minimalist,	,Mehanizma u Arushi. Ovaj građevinski projekat,, koji odslikava štedljiv i minimalistički pristup i u,
,approach and incorporates best practices from other UN capital projects,, has taken place under the,	,kojem su otelotvorene najbolje prakse iz drugih kapitalnih projekata Ujedinjenih nacija,, urađen je,
,stewardship of this Assembly and remains—importantly—on budget. In the meantime,, both Tanzania,	,pod pokroviteljstvom ove Skupštine i ostaje,, što je veoma važno,, u okviru predviđenih budžetskih,
,and the Netherlands,, as the Host States of our respective branches,, continue to support the,	,izdataka. U međuvremenu,, i Tanzanija i Holandija,, kao zemlje domaćini odgovarajućih ogranaka,
Mechanism’s work on a near daily basis in countless but meaningful ways.	,Mahanizma,, nastavljaju da podržavaju rad Mehanizma na skoro svakodnevnoj osnovi na bezbroj važnih,
It is thanks to the support and assistance of Member States in Africa and Europe that we are able to	načina. Zahvaljujući podršci i pomoći država članica iz Afrike i Evrope uspeli smo da na izvršenje kazne
,enforce sentences pronounced by the ICTR,, the ICTY,, and the Mechanism. The support and,	,pošaljemo lica koja su osudili MKSR,, MKSJ i Mehanizam. Podrška i saradnja pojedinačnih država članica,
cooperation of individual Member States is likewise essential in resolving the situation faced by the	je isto tako od presudne važnosti u rešavanju situacije u kojoj se nalazi Mehanizam u vezi s
Mechanism with regard to individuals indicted by the ICTR who were subsequently acquitted or	,pojedincima protiv kojih je MKSR podigao optužnice,, a koji su naknadno oslobođeni krivice ili pušteni,
,released in Tanzania. The appropriate relocation of these individuals,, as I have stated before,, is a,	,na slobodu u Tanzaniji. Odgovarajuća relokacija tih pojedinaca,, kao što sam i ranije napominjao,,,
,crucial challenge for international justice,, and a humanitarian imperative.,	ključni je izazov za međunarodno pravosuđe i predstavlja humanitarni imperativ.
,And of course,, the Mechanism will not have fulfilled its mandate unless and until all remaining,	,I,, naravno,, Mehanizam neće ispuniti svoj mandat ukoliko i sve dok se svi optuženi pred MKSR koji su u,
fugitives indicted by the ICTR have been called to account. Success on this front will depend in great	bekstvu ne privedu pravdi. Uspeh na tom polju će u velikoj meri zavisiti od blagovremene saradnje
part upon the timely cooperation of individual Member States. I wish the greatest success to	pojedinačnih država članica. Tužiocu Brammertzu želim svaki uspeh u njegovim kontinuiranim
Prosecutor Brammertz in his continuing efforts in this regard.	naporima u tom pogledu.
,Indeed,, as we move forward,, seeking to fulfil all other aspects of our mandate in the best way,	,I zaista,, kako u budućnosti budemo nastojali da na najbolji mogući način ispunimo sve druge aspekte,
,possible,, the cooperation and support of the United Nations and its Members form the essential and,	,mandata koji nam je poveren,, saradnja i podrška Ujedinjenih nacija i zemalja članica predstavljaće,
invaluable basis for all our efforts.	ključnu i neprocenjivu osnovu svih naših napora.
,Mr. President,, Excellencies,, it is in this context that I find that I must advise the Assembly of a serious,	,Gospodine predsedniče,, ekselencije,, u tom kontekstu smatram da ovu Skupštinu moram obavestiti o,
matter impacting upon the effective discharge of the Mechanism’s mandate.	jednom ozbiljnom pitanju koje ima uticaj na efikasno ispunjavanje mandata Mehanizma.
,On 20 December 2011,, following nomination by the Government of Turkey,, this Assembly elected,	,Ova Skupština je,, nakon što je bio nominovan od strane Vlade Turske,, 20. decembra 2011. izabrala,
,Judge Aydin Sefa Akay,, of Turkey,, as a Judge of the Mechanism. This election followed Judge Akay’s,	,sudiju Aydina Sefa Akaya,, iz Turske,, za sudiju Mehanizma. Taj izbor je usledio nakon uzornog,
,distinguished prior service as a Judge of the ICTR and,, earlier,, as an Ambassador of Turkey. After,	,prethodnog rada na funkciji sudije MKSR,, i pre toga,, funkciji ambasadora Turske. Nakon konsultacija,
consultation by the Secretary-General with the Presidents of this Assembly and of the Security	,koje je generalni sekretar obavio sa predsedavajućima ove Skupštine i Saveta bezbednosti,, sudija Akay,
,Council,, Judge Akay was recently appointed for a new term as Judge of the Mechanism,, commencing 1,	,je nedavno imenovan na novi mandat kao sudija Mehanizma,, počevši od 1. jula 2016.,
,July 2016. On 25 July 2016,, as President of the Mechanism,, I appointed Judge Akay to a Bench of the Appeals,	Kao predsednik Mehanizma 25. jula 2016. sam imenovao sudiju Akaya u veće koje treba da razmotri
Chamber to address a motion for review of judgement and associated applications advanced by Mr.	,zahtev za preispitivanje presude i povezane zahteve koje je dostavio Augustin Ngirabatware,, koji je,
,Augustin Ngirabatware,, who is currently detained following his conviction.,	trenutno u pritvoru nakon što je osuđen.
,Without notification to the United Nations or the Mechanism,, on or around 21 September 2016,, Judge,	,Bez ikakvog obaveštenja Ujedinjenim nacijama ili Mehanizmu,, 21. septembra 2016. ili približno tog,
Akay was detained in Turkey in relation to allegations connected to the events of July 2016 directed	datuma sudija Akay je pritvoren u Turskoj u vezi s navodima povezanim s događajima iz jula 2016.
,against the constitutional order of Turkey,, and has remained in detention since that time. As a result,	,usmerenih protiv ustavnog poretka Turske,, i od tada se nalazi u pritvoru. Kao posledica toga što je,
,of Judge Akay’s detention,, the proceedings to which he has been assigned have necessarily come to a,	,sudija Akay u pritvoru,, postupak u kojem je imenovan da postupa nužno je prekinut,, s odgovarajućim,
,standstill,, with corresponding implications for the fundamental rights of the applicant to the,	implikacijama na osnovna prava podnosioca zahteva na utvrđivanje osnovanosti njegovog zahteva u
determination of his claims within a reasonable time.	razumnom roku.
,Mr. President,, Excellencies,, judicial independence is a cornerstone of the rule of law,, and it is a,	,Gospodine predsedniče,, ekselencije,, sudijska nezavisnost predstavlja okosnicu vladavine prava i,
longstanding and consistent practice to accord international Judges privileges and immunities in order	dugogodišnja je i dosledna praksa da međunarodne sudije uživaju privilegije i imunitete kako bi se
to protect the independent discharge of their judicial functions. The Security Council accorded the	,zaštitila nezavisnost obavljanja njihovih funkcija. Savet bezbednosti je,, iz tog razloga,, dodelio,
,Judges of both the ICTR and the ICTY diplomatic immunity to that end. The Statute of the Mechanism,,,	,diplomatski imunitet i sudijama MKSR i MKSJ. Statut Mehanizma,, koji je Savet bezbednosti usvojio,
,adopted by the Council acting under Chapter VII of the UN Charter,, likewise accords the Judges of the,	,delujući u skladu s poglavljem VII Povelje Ujedinjenih nacija,, takođe sudijama Mehanizma pruža,
Mechanism diplomatic immunity for those periods of time in which they are engaged on the business	diplomatski imunitet za vremenske periode tokom kojih obavljaju poslove u ime Mehanizma.
,of the Mechanism. In according the Judges of the Mechanism such immunity,, the Council necessarily,	,Dodeljujući sudijama Mehanizma takav imunitet,, Savet bezbednosti je nužno shvatio da,, zahvaljujući,
,understood that,, thanks to the Mechanism’s lean and efficient design and the statutory expectation,	štedljivoj i efikasnoj prirodi Mehanizma i Statutom zacrtanih očekivanja da sudije rade na daljinu što
,that Judges will work remotely as much as possible and away from the seats of the Mechanism,, the,	,je više moguće,, i van sedišta ogranaka Mehanizma,, sudije veći deo vremena obavljaju svoje,
Judges would typically be carrying out their judicial work for the Mechanism in their State of	pravosudne funkcije za Mehanizam u državi čiji su državljani.
,nationality. As a result of this legal framework,, Judge Akay enjoyed diplomatic immunity from the time of his,	,Kao posledica takvog pravnog okvira,, sudija Akay je uživao diplomatski imunitet od trenutka kada je,
,assignment to the Ngirabatware proceedings on 25 July,, and continues to enjoy such immunity,	,imenovan u postupak u predmetu Ngirabatware,, odnosno od 25 jula,, i nastavlja da uživa takav,
through to the conclusion of those proceedings.	imunitet sve do okončanja tog postupka.
,The UN Office of Legal Affairs,, on behalf of the Secretary-General,, has formally asserted this,	,Služba za pravne poslove Ujedinjenih nacija je,, u ime generalnog sekretara,, formalno potvrdila Vladi,
,protection to the Government of Turkey,, and,, as a consequence,, requested Judge Akay’s immediate,	,Turske njegov zaštićeni status,, i shodno tome zatražila da sudija Akay odmah bude pušten iz pritvora,
,release from detention and the cessation of all legal proceedings against him. In the meantime,, on 17,	,te da se prekinu svi pravosudni postupci protiv njega. U međuvremenu sam,, 17. oktobra 2016,, u,
,October 2016,, as President of the Mechanism,, I formally requested permission of the Government to,	svojstvu predsednika Mehanizma formalno zatražio dozvolu Vlade Turske da posetim sudiju Akaya kako
visit Judge Akay to consult him confidentially and ascertain his conditions of detention.	bih se s njim konsultovao na poverljivoj osnovi i kako bih utvrdio uslove njegovog pritvora.
,Mr. President,, Excellencies,, I deeply regret that the Government of Turkey has thus far provided no,	,Gospodine predsedniče,, ekselencije,, s velikim žaljenjem vas moram obavestiti da Vlada Turske do,
,formal communication whatsoever on these matters to either the United Nations or the Mechanism,,,	sada nije pružila nikakvu formalnu komunikaciju u vezi s ovim pitanjima ni Ujedinjenim nacijama niti
,and that the Government continues to maintain Judge Akay’s detention,, in breach of the Statute of,	,Mehanizmu,, te da Vlada i dalje sudiju Akaya drži u pritvoru,, kršeći Statut Mehanizma i obavezu Turske,
the Mechanism and of Turkey’s obligation to cooperate with the Mechanism in accordance with	
,operative paragraph 9 of Security Council resolution 1966 (2010). I likewise regret that,, as a result of,	da sarađuje s Mehanizmom u skladu s operativnim paragrafom 9 Rezolucije 1966 (2010) Saveta
,Judge Akay’s detention,, the will of this Assembly that he discharge judicial functions for the,	,bezbednosti. Takođe sa žaljenjem mogu konstatovati da je istovremeno,, kao posledica pritvaranja,
,Mechanism,, consistent with the provisions of the Statute pursuant to which he was elected and then,	,sudije Akaya,, onemogućena namera ove Skupštine da on obavlja sudijsku funkciju za Mehanizam u,
,appointed to a new term,, is concurrently being frustrated.,	,skladu s odredbama Statuta na osnovu kojih je prvo izabran,, a kasnije i imenovan na drugi mandat.,
,As Judge Akay’s detention becomes increasingly prolonged,, its effects on the Mechanism’s ability to,	,Kako boravak sudije Akaya u pritvoru postaje sve duži,, to je uticaj na sposobnost Mehanizma da,
,perform its core mandate become ever more pronounced,, as this detention has materially impeded,	,obavlja svoj osnovni mandat sve veći,, pošto je ovo pritvaranje suštinski ograničilo mogućnost,
,the Mechanism’s ability to perform one of its most fundamental functions: to judicially determine,, in,	,Mehanizma da obavlja jednu od svojih najosnovnijih funkcija: da sudski utvrđuje,, u skladu sa,
,accordance with the law,, matters going to an individual’s responsibility for the most serious,	,zakonom,, pitanja koja se tiču individualne odgovornosti za najteža međunarodna krivična dela. Bez,
,international crimes. Absent clear understanding of his conditions of detention,, and a response to my,	,jasnog razumevanja uslova njegovog pritvora,, i bez odgovora na moj zahtev da mi se dozvoli da,
,request for authorization to visit Judge Akay,, my concern for my judicial colleague’s welfare from a,	,posetim sudiju Akaya,, moja zabrinutost za dobrobit mog kolege sudije postaje sve veća i sa,
humanitarian standpoint likewise becomes all the stronger.	humanitarne strane.
,I therefore call upon the Government of Turkey,, consistent with its binding international obligations,	Stoga pozivam Vladu Turske da u skladu sa svojim obavezujućim međunarodnim dužnostima prema
,under Chapter VII of the UN Charter,, to immediately release Judge Akay from detention and enable,	poglavlju VII Povelje Ujedinjenih nacija odmah oslobodi sudiju Akaya iz pritvora i omogući mu da
him to resume his lawfully-assigned judicial functions.	,nastavi da obavlja svoje sudijske funkcije,, na koje je zakonito imenovan.,
,Mr. President,, Excellencies,, in discharging our mandates to pursue justice and accountability for the,	,Gospodine predsedniče,, ekselencije,, ispunjavajući svoje mandate u ostvarivanju pravde i pozivanju na,
,most serious crimes known to humanity,, international criminal tribunals such as the Mechanism serve,	,odgovornost za najteže zločine znane čovečanstvu,, međunarodni krivični sudovi poput Mehanizma,
,the interests of all States and their peoples. At the same time,, however—and as the past twenty-five,	
years have demonstrated—international criminal tribunals are fully dependent both on the cooperation	,služe interesima svih država i njihovih naroda. Međutim,, u isto vreme,, kako su nam proteklih dvadeset,
of States and on States’ respect for the international legal framework applicable to each institution.	,pet godina pokazale,, međunarodni krivični sudovi u potpunosti zavise i od saradnje država i od,
,Without such cooperation and respect,, international courts cannot ensure their independent,	poštovanja tih država za međunarodne pravne okvire primenjive u svakoj takvoj instituciji. Bez takve
,operation,, wherever around the world court functions may be exercised,, and they therefore cannot,	,saradnje i poštovanja,, međunarodni sudovi ne mogu obezbediti svoj nezavistan rad,, gde god na svetu,
carry out the vital mandates entrusted to them.	,sudske funkcije bile izvršavane,, i stoga ne mogu izvršavati ključne mandate koji su im povereni.,
I have every confidence that the Government of Turkey shares this common interest in enabling the	Uveren sam da Vlada Turske deli ovaj zajednički interes da se Mehanizmu omogući da funkcioniše
,Mechanism to function efficiently and effectively,, in accordance with its mandate and with applicable,	,efikasno i delotvorno,, u skladu s mandatom koji mu je poveren i merodavnim pravom,, i da će Vlada s,
,law,, and that the Government will,, without further delay,, take the necessary steps with respect to,	,tim ciljem,, bez odlaganja,, preduzeti potrebne korake u vezi sa situacijom koju sam opisao.,
the situation I have described towards that end.	
The resolution of this matter is critically important not simply for the Mechanism. It is essential for all	Razrešenje ovog pitanja je od presudne važnosti ne samo za Mehanizam. Ono je ključno za sve nas
of us if we are to ensure that UN institutions are able to carry out their mandates in accordance with	kako bismo obezbedili da institucije Ujedinjenih nacija budu u stanju da ispunjavaju svoje mandate u
,the law and in the absence of interference. It is essential for all of us if we are,, working together,, to,	,skladu sa zakonom i neometano. Ovo je ključno za sve nas kako bismo,, radeći zajedno,, doveli do ere,
,bring about an era of accountability based upon and enshrining respect for the rule of law,, for which,	pozivanja na odgovornost koja će se temeljiti na poštovanju vladavine prava i predstavljati njeno
judicial independence is fundamental. It is essential for all of us who wish to be able to say that we	,otelotvorenje,, a za to je sudijska nezavisnost fundamentalna. Ovo je ključno za sve nas koji želimo da,
have done all that we can to end impunity for horrific crimes in violation of international law and to	kažemo da smo učinili sve što možemo kako bismo okončali nekažnjivost za užasne zločine počinjene
seek to bring about a world in which the highest humanitarian principles are upheld. But to	kršenjem međunarodnog prava i koji želimo da izgradimo svet u kojem se poštuju najviši humanitarni
,accomplish all of this,, it is essential that all Members of the United Nations,, in addressing vital,	,principi. Da bi se sve ovo postiglo,, od presudne je važnosti da sve članice Ujedinjenih nacija,,,
,requests from Chapter VII tribunals,, act in accordance with good faith,, the duty to cooperate,, and,	,odgovarajući na ključne zahteve međunarodnih sudova u skladu s poglavljem VII,, deluju u skladu s,
unimpeachable due process.	,dobrom verom,, dužnošću da sarađuju i potpunom zakonitošću postupka.,
Thank you.	Hvala vam.
UNITED NATIONS	UJEDINJENE NACIJE
International Residual Mechanism for Criminal Tribunals	Međunarodni rezidualni mehanizam za krivične sudove
The International Residual Mechanism for Criminal Tribunals (“Mechanism”) was established on 22 December 2010 by the United Nations Security Council to	Međunarodni rezidualni mehanizam za krivične sudove (Mehanizam) osnovao je Savjet bezbjednosti Ujedinjenih nacija 22. decembra 2010. da nastavi
,continue the jurisdiction,, rights,, obligations and essential functions of the International Criminal Tribunal for Rwanda (“ICTR”) and the International Criminal,	,nadležnosti,, prava,, obaveze i ključne funkcije Međunarodnog krivičnog suda za Ruandu (MKSR) i Međunarodnog krivičnog suda za bivšu Jugoslaviju (MKSJ) nakon,
,Tribunal for the former Yugoslavia (“ICTY”) which closed in 2015 and 2017,, respectively,	,okončanja njihovih mandata 2015.,, odnosno 2017. godine. IZJAVA,
STATEMENT	PREDSJEDNIK
PRESIDENT (Exclusively for the use of the media. Not an official document)	(Isključibvo za medije. Nije zvanični dokument)
,Arusha,, The Hague,, 17 July 2019,	,Arusha,, Haag,, 17. juli 2019.,
Address to the UN Security Council	Obraćanje Savjetu bezbjednosti UN-a
Judge Carmel Agius	sudija Carmel Agius
,President,, International Residual Mechanism for Criminal Tribunals,	,predsjednik,, Međunarodni rezidualni mehanizam za krivične sudove,
17 July 2019	17. juli 2019.
,Mr President,, Excellencies,, Ladies and Gentlemen,,,	,Gospodine predsjedniče,, ekscelencije,, dame i gospodo,,,
I feel deeply honoured to have once again the privilege of addressing the Security Council; this time as the new	,Osjedam se duboko počašdenim što još jednom imam čast obratiti se Savjetu bezbjednosti,, ovaj put kao novi,
President of the International Residual Mechanism for Criminal Tribunals (Mechanism). I am fortunate to have	predsjednik Međunarodnog rezidualnog mehanizma za krivične sudove (Mehanizam). Imao sam sredu da
,assumed the leadership of the Mechanism when the institution is strong and well-established,, thanks to the,	,preuzmem vođstvo Mehanizma kada je ta institucija snažna i dobro organizovana,, zahvaljujudi neumornom i,
,unstinting and outstanding work of my predecessor,, Judge Theodor Meron,, together with that of my esteemed,	,izvanrednom radu mog prethodnika,, sudije Theodora Merona,, zajedno sa mojim cijenjenim kolegama,, izvrsnim,
,Colleagues,, the Mechanism’s remarkable Judges,, and of course its wonderful staff.,	,sudijama Mehanizma i,, naravno,, njegovim odličnim osobljem.,
This is not to say that my first months have been easy. The role of Mechanism President is a demanding one:	Time ne želim redi da su mi prvi mjeseci bili laki. Uloga predsjednika Mehanizma je zahtjevna: rukovođenje
,running an institution spread across two continents,, with Judges and staff coming from numerous legal systems,	,institucijom koja se nalazi na dva kontinenta,, sa sudijama i osobljem koji dolaze iz brojnih pravnih sistema i,
,and diverse backgrounds,, working in different time zones; with our focus split between the residual judicial,	,raznovrsnih konteksta,, rad u različitim vremenskim zonama,, s težištem pažnje podijeljenim između rezidualnih,
matters arising out of two very distinct conflicts and resulting from the closure of the International Criminal	sudskih predmeta koji proističu iz dva veoma različita sukoba i koji su preuzeti uslijed okončanja rada
Tribunal for Rwanda (ICTR) and the International Criminal Tribunal for the former Yugoslavia (ICTY). I already	Međunarodnog krivičnog suda za Ruandu (MKSR) i Međunarodnog krivičnog suda za bivšu Jugoslaviju (MKSJ). Ved
,knew of these unique circumstances before assuming the Presidency,, of course,, because I have been a Judge of,	,su mi bile poznate ove jedinstvene okolnosti prije preuzimanja dužnosti predsjednika,, naravno,, zbog toga što sam,
,the Mechanism since it came into operation in 2012,, and was a Judge of the ICTY for many years before that.,	,bio sudija Mehanizma od njegovog početka rada 2012.,, a sudija MKSJ-a sam bio mnogo godina prije toga. Ipak,,,
,Nevertheless,, I have been surprised and enthralled by the extent to which the Mechanism differs from its predecessor institutions.,	iznenađen sam i fasciniran time u kojoj mjeri se Mehanizam razlikuje od svojih institucija prethodnica.
,Despite our unique mandate and the many challenges that no doubt lie ahead,, I remain fully committed: first and,	,Uprkos našem jedinstvenom mandatu i mnogim izazovima koji su nesumnjivo pred nama,, ostajem u potpunosti,
,foremost,, to the efficient and timely conclusion of the judicial proceedings at both the Arusha and The Hague,	,opredijeljen,, prvo i prije svega,, za efikasno i blagovremeno okončanje sudskih postupaka u ograncima Mehanizma,
,branches of the Mechanism,, bearing in mind due process and fundamental fair trial rights; second,, to enhancing,	,i u Arushi i u Haagu,, imajudi u vidu pravičnost postupka i osnovna prava na pravično suđenje; drugo,, za jačanje,
,inter-branch coordination and harmonisation of practices and procedures; and third,, to doing my utmost to foster,	,koordinacije između ogranaka i usklađivanje prakse i postupaka,, i trede,, da učinim sve što je u mojoj modi da,
a working environment that encourages high staff morale and performance. This is in line with the priorities I	osnažim radno okruženje koje stimuliše visok moral i učinak osoblja. Ovo je u skladu s prioritetima koje sam
,announced at the start of my Presidency,, which are elaborated in document S/2019/417,, being the Mechanism’s,	,najavio kada sam preuzeo dužnost predsjednika,, koji su elaborirani u dokumentu S/2019/417,, izvještaju o,
progress report for the period 16 November 2018 to 15 May 2019. I must add that this report partly reflects the	napretku Mehanizma za period od 16. novembra 2018. do 15. maja 2019. Moram dodati da ovaj izvještaj
,work of the Mechanism under President Meron’s guidance until 19 January of this year,, when I took over the,	,djelimično odražava rad Mehanizma pod vođstvom predsjednika Merona do 19. januara ove godine,, kada sam ja,
leadership of this fine institution from him.	preuzeo rukovođenje ovom izuzetnom institucijom od njega.
International Residual Mechanism for Criminal Tribunals	Međunarodni rezidualni mehanizam za krivične sudove
Arusha Tel.: +255 (0)27 256 5376	Arusha Tel: +255 (0)27 256 5376
The Hague Tel.: +31 (0)70 512 5691	Haag Tel: +31 (0)70 512 5691
Email: mict-press@un.org	Email: mict-press@un.org
,Follow us on Facebook,, Twitter,, YouTube,, LinkedIn,	,Pratite nas na Facebooku,, Twitteru,, YouTubeu,, LinkedInu,
www.unmict.org	www.irmct.orgMRMKS
IRMCT	IZJAVA
STATEMENT	PREDSJEDNIK
,PRESIDENT Mr President,,,	,Gospodine predsjedniče,,,
,As set out in the report before you,, the Mechanism continues to work vigorously towards concluding its residual,	,Kako je navedeno u izvještaju koji je pred vama,, Mehanizam nastavlja vrijedno raditi ka okončanju svog,
,judicial workload. Notably,, most of this work has been performed by Judges working remotely with the assistance,	rezidualnog sudskog rada. Posebno vrijedi istadi da najvedi dio ovog posla obavljaju sudije koje rade na daljinu uz
,of Chambers staff at both branches,, in accordance with the imperative to operate in a cost-efficient manner. In,	,pomod osoblja vijeda u oba ogranka,, u skladu s imperativom da se radi na ekonomičan način. Za sedam godina,
,the Mechanism’s seven years of existence,, its Judges have had only two opportunities to come together for the,	,postojanja Mehanizma,, njegove sudije su imale samo dvije prilike da se sastanu za potrebe plenarnih sjednica uz,
,purpose of in-person Plenary sessions. The second in-person Plenary of Judges,, and the first to be held at the,	,lično prisustvo. Druga plenarna sjednica uz lično prisustvo sudija,, a prva koja je održana u ogranku Mehanizma u,
,Mechanism’s Arusha branch,, took place earlier this year in March,, offering my Colleagues and me a tremendous,	,Arushi,, održana je ranije ove godine u martu,, što je mojim kolegama i meni dalo značajnu priliku da razmotrimo,
,opportunity to discuss practical and substantial matters,, familiarise ourselves with the new courtroom,, and get to,	,praktična i suštinska pitanja,, upoznamo se s novom sudnicom i da upoznamo naše posvedeno osoblje u Tanzaniji.,
,know our dedicated staff in Tanzania. This was a most valuable meeting,, which I hope will be repeated,	,Ovo je bio veoma dragocjen sastanak,, a nadam se da de se takvi sastanci periodično ponavljati.,
,periodically. Turning to our workload,, I am pleased to note that the Appeal Judgement in the Karadžid case was delivered on,	,U vezi s našim radom,, sa zadovoljstvom napominjem da je Drugostepena presuda u predmetu Karadžid izrečena,
,20 March 2019,, representing a milestone for the Mechanism in the conclusion of one of its most significant cases.,	,20. marta 2019.,, što predstavlja istorijski trenutak za Mehanizam u zaključenju jednog od svojih najznačajnijih,
,Remarkably,, the timely adjudication of the case was achieved despite changes in the Bench at a very late stage. I,	predmeta. Valja napomenuti da je blagovremeno donošenje presude u ovom predmetu postignuto uprkos
,wish to particularly commend Judge Vagn Joensen,, who took over as the Presiding Judge,, and Judge Ivo Nelson de,	,promjenama u Vijedu u veoma kasnoj fazi. Želim naročito da pohvalim sudiju Vagna Joensena,, koji je preuzeo,
,Caires Batista Rosa,, who upon being newly assigned to the case was able to quickly take up the complex and large,	,dužnost predsjedavajudeg sudije,, te sudiju Ivu Nelsona de Caires Batista Rosu,, koji je kao novi sudija raspoređen,
responsibilities entrusted to him.	na predmet bio u stanju da brzo preuzme složene i velike odgovornosti koje su mu povjerene.
,In relation to the other ongoing cases in The Hague,, I am likewise pleased to report that changes in late 2018 to,	,U vezi s drugim predmetima u kojima se vodi postupak u Haagu,, takođe mi je zadovoljstvo da izvijestim da,
,the Bench assigned to the Mladid case have also not resulted in any delays to the appeal proceedings,, which are,	promjene krajem 2018. godine u Vijedu kojem je dodijeljen predmet Mladid takođe nisu dovele ni do kakvih
,progressing smoothly. I am grateful to the Presiding Judge,, Judge Prisca Matimba Nyambe and the other Judges,	,zastoja u žalbenom postupku,, koji nesmetano napreduje. Zahvalan sam predsjedavajudoj sutkinji,, sutkinji Prisci,
,on the Bench,, whose diligence together with that of the Chambers team has allowed the case to remain on track,	,Matimba Nyambe,, i drugim sudijama Vijeda čiji je revnostan rad zajedno sa timom vijeda omogudio da okončanje,
,for conclusion by the end of 2020. Solid progress is also being made in the Stanišid & Simatovid re-trial,, with the,	predmeta bude i dalje planirano za kraj 2020. Solidan napredak takođe je ostvaren na ponovnom suđenju u
,Defence case underway as of 18 June 2019. Thanks to the dedication of the Presiding Judge,, Judge Burton Hall,	,predmetu Stanišid i Simatovid,, u kom je od 18. juna 2019. u toku dokazni postupak odbrane. Zahvaljujudi,
,and the rest of the Bench and assigned staff,, the Trial Judgement in this case also remains on schedule for,	,posvedenosti predsjedavajudeg sudije,, sudije Burtona Halla,, i ostalih članova Vijeda i dodijeljenog osoblja,,,
delivery by the end of 2020.	,Prvostepena presuda u ovom predmetu takođe de biti izrečena po rasporedu,, do kraja 2020.,
,In Arusha,, the Ngirabatware review proceedings are currently expected to be heard in September of this year. As,	,U Arushi,, trenutno se očekuje da postupak preispitivanja u predmetu Ngirabatware bude održan u septembru ove,
,you may be aware,, the replacement of Mr. Ngirabatware’s counsel and the disclosure of voluminous material,	,godine. Kao što vam je možda poznato,, zamjena branioca g. Ngirabatwarea i objelodanjivanje voluminoznog,
,from a related contempt case resulted in the postponement of the review hearing,, which had previously been,	,materijala iz povezanog predmeta zbog nepoštovanja suda doveli su do odgađanja pretresa o preispitivanju,, koji,
scheduled for September 2018.	je prethodno bio zakazan za septembar 2018.
,In addition to these proceedings,, which relate to core crimes within the jurisdiction of the Mechanism,, the,	,Pored ovih postupaka,, koji se odnose na osnovna krivična djela u nadležnosti Mehanizma,, Mehanizam rješava u,
Mechanism is seised of a number of cases pertaining to allegations of contempt of court. I refer in particular to	brojnim predmetima koji se tiču navoda o nepoštovanju suda. Posebno skredem pažnju na predmet sa više
,the multi-accused Turinabo et al. case,, in which a Single Judge continues to conduct pre-trial proceedings and to,	,optuženih Turinabo i drugi,, u kom sudija pojedinac nastavlja da vodi pretpretresni postupak i razmatra brojne,
deal with numerous motions filed by the five accused. It is anticipated that the trial will start in October 2019 and	zahtjeve koje je podnijelo petoro optuženih. Očekuje se da de suđenje započeti u oktobru 2019. i biti zaključeno u
,conclude in the first semester of 2020. Here I would like to add that the Appeals Chamber,, myself presiding,, is,	,prvom polugodištu 2020. Ovdje želim dodati da Žalbeno vijede,, kojim lično predsjedavam,, takođe rješava po više,
,also seised of several appeals of pre-trial decisions of the Single Judge,, and is exerting its best efforts to ensure,	žalbi na pretpretresne odluke sudije pojedinca i čini sve u svojoj modi da obezbijedi da odluke po njima budu
,that these are adjudicated as expeditiously as possible,, in order to allow the trial to start on time.,	,donesene što je ekspeditivnije mogude,, kako bi se omogudilo da suđenje započne na vrijeme.,
,Another contempt case,, the case of Petar Jojid & Vjerica Radeta,, is presently back before the Mechanism. This,	,Drugi predmet zbog nepoštovanja suda,, predmet Petar Jojid i Vjerica Radeta,, sada je vraden Mehanizmu. Ovaj,
case was in 2018 referred to the authorities of Serbia for trial but was subsequently remanded back to a Single	,predmet je 2018. godine bio proslijeđen vlastima Srbije radi suđenja,, ali je naknadno vraden sudiji pojedincu po,
,Judge following an appeal by the amicus curiae prosecutor. In May of this year,, the Single Judge revoked the,	,žalbi amicus curiae tužioca. U maju ove godine,, sudija pojedinac povukao je nalog o prosljeđivanju i zatražio od,
previous referral order and requested Serbia to transfer the accused to the Mechanism without delay. While the	,Srbije da bez odlaganja preda optužene Mehanizmu. Iako to dvoje optuženih nisu uložili žalbu protiv ove odluke,,,
,two accused have not filed an appeal against this decision,, Serbia has,, and the matter is currently pending before the Appeals Chamber.,	,Srbija jeste,, tako da tu stvar sada rješava Žalbeno vijede.,
International Residual Mechanism for Criminal Tribunals	Međunarodni rezidualni mehanizam za krivične sudove
Arusha Tel.: +255 (0)27 256 5376	Arusha Tel: +255 (0)27 256 5376
The Hague Tel.: +31 (0)70 512 5691	Haag Tel: +31 (0)70 512 5691
Email: mict-press@un.org	Email: mict-press@un.org
,Follow us on Facebook,, Twitter,, YouTube,, LinkedIn,	,Pratite nas na Facebooku,, Twitteru,, YouTubeu,, LinkedInu,
www.irmct.org	www.irmct.orgMRMKS
IRMCT	IZJAVA
STATEMENT	PREDSJEDNIK
,PRESIDENT Mr President,,,	,Gospodine predsjedniče,,,
,What you have just heard relates to the most visible aspect of the Mechanism’s mandate,, namely its residual,	
,judicial workload. It is clear that our trials and appeals,, and especially our decisions,, orders and judgements,, are,	,Ono što ste upravo čuli odnosi se na najvidljiviji aspekt mandata Mehanizma,, odnosno na njegov rezidualni sudski,
,followed closely not only by the countries most affected by our work,, namely Rwanda and those in the region of,	,rad. Jasno je da naša suđenja i žalbeni postupci,, a posebno naše odluke,, nalozi i presude,, pažljivo prate ne samo,
,the former Yugoslavia,, but other United Nations Member States and numerous stakeholders around the world.,	,zemlje na koje naš rad najviše utiče,, odnosno Ruanda i države u regionu bivše Jugoslavije,, nego i druge države,
,Less attention,, however,, is paid to the Mechanism’s additional statutory functions,, which include protecting,	,članice Ujedinjenih nacija i brojni zainteresovani širom svijeta. Manja pažnja se,, međutim,, posveduje dodatnim,
,victims and witnesses,, monitoring cases referred to national jurisdictions,, preserving the archives of the ICTR,, the,	,statutarnim funkcijama Mehanizma,, koje uključuju zaštitu žrtava i svjedoka,, pradenje predmeta proslijeđenih,
,ICTY and the Mechanism itself,, addressing requests for assistance from national jurisdictions,, and supervising the,	,nacionalnim jurisdikcijama,, čuvanje arhiva MKSR-a,, MKSJ-a i Mehanizma,, razmatranje zahtjeva za pomod iz,
enforcement of sentences.	,nacionalnih jurisdikcija,, te nadzor nad sprovođenjem kazni.,
I would therefore like to share some of my reflections since assuming the Presidency on what it means to manage	Stoga bih želio podijeliti neke od svojih refleksija od preuzimanja dužnosti predsjednika o tome šta znači upravljati
,some of these residual matters,, and will focus my remarks here on enforcement issues.,	,nekim od ovih rezidualnih funkcija,, i usredsredidu svoje napomene ovdje na pitanja u vezi sa sprovođenjem kazni.,
,My first observation may be an obvious one,, namely that justice does not end with the delivery of a judgement. I,	,Moja prva opservacija može biti očigledna,, naime to da pravda nije zadovoljena samim izricanjem presude. Mislim,
,am referring here to post-conviction matters,, which are a little-understood but crucial part of the Mechanism’s,	,ovdje na stvari poslije izricanja osuđujude presude,, koje predstavljaju malo shvaden ali ključni dio rada,
work. The legal framework of the Mechanism grants me as President broad powers to supervise the enforcement	Mehanizma. Pravni okvir Mehanizma daje meni kao predsjedniku široka ovlaštenja za nadzor nad sprovođenjem
,of sentences,, and I do not take these responsibilities lightly. Determinations as to where a convicted person will,	,kazni i ja te odgovornost ne shvatam olako. Odluke o tome gdje de osuđena osoba izdržavati svoju kaznu,, da li on,
,serve his or her sentence,, whether he or she should be transferred to continue a sentence elsewhere,, or whether,	,ili ona treba biti prebačen/a da nastavi izdržavati kaznu negdje drugdje,, odnosno da li neka osoba može ispuniti,
,a person may be eligible to be considered for early release,, pardon or commutation of sentence,, are extremely,	,uslove da bude uzeta u obzir za prijevremeno puštanje na slobodu,, pomilovanje ili ublažavanje kazne,, krajnje su,
,important. They are also very sensitive,, relating inter alia to the rights of detainees and concerning sentences,	,značajne. One su takođe veoma osjetljive,, jer se odnose,, između ostalog,, na prava zatvorenika i na kazne izrečene,
,imposed as a result of painstaking,, often lengthy trial and appeal proceedings concerning the gravest violations of,	,kao rezultat mukotrpnih,, često dugotrajnih suđenja i žalbenih postupaka u vezi s najtežim kršenjima,
,international criminal law. My duty is and remains to apply the law,, and I will continue to do so responsibly,,,	međunarodnog krivičnog prava. Moja obaveza jeste i ostaje da primjenjujem pravo i nastavidu to da činim
,thoroughly,, and with as much transparency as possible. I would recall that,, pursuant to the Mechanism’s legal,	,odgovorno,, temeljito i sa što je mogude više transparentnosti. Podsjetio bih da se,, na osnovu pravnog okvira,
,framework,, such decisions involve the exercise of discretionary functions by the President,, and require a careful,	,Mehanizma,, takve odluke tiču vršenja diskrecionih funkcija predsjednika,, te iziskuju pažljivo ocjenjivanje i,
case-by-case assessment and balancing of factors.	odmjeravanje faktora od slučaja do slučaja.
,Second,, as a judicial institution the Mechanism is bound to strictly observe its duty to safeguard the rights of all,	,Drugo,, kao sudska institucija Mehanizam je obavezan da strogo poštuje svoju obavezu da štiti prava svih svojih,
,its detainees,, whether subject to pending or ongoing proceedings or awaiting transfer to an Enforcement State.,	,zatvorenika,, bilo da podliježu predstojedim ili postupcima koji su u toku,, bilo da čekaju na transfer u državu,
,As of 5 December 2018,, the Mechanism is now implementing a new regulatory framework on detention matters,	,sprovođenja kazne. Od 5. decembra 2018,, Mehanizam sada primjenjuje novi regulatorni okvir za pitanja,
,that I believe can serve as a model to other institutions. In this regard,, the Mechanism has been guided by the,	,sprovođenja kazni za koji vjerujem da može poslužiti kao model za druge institucije. U tom pogledu,, Mehanizam,
,need to harmonise practices between the Arusha and The Hague detention facilities,, and by standards enunciated,	,se rukovodi potrebom za usklađivanjem prakse između pritvorskih jedinica u Arushi i Haagu,, te standardima koje,
,by the General Assembly through its adoption of the Nelson Mandela Rules (A/RES/70/175). Moreover,, it has,	,je usvojila Generalna skupština kada je usvojila Pravila Nelsona Mandele (A/RES/70/175). Pored toga,, Mehanizam,
,sought to build upon those standards through detailed procedures governing visits,, communications,, complaints,,,	,nastoji nadograditi te standarde kroz detaljne procedure za posjete,, komunikacije,, žalbe i disciplinske stvari u,
and disciplinary matters in a detention setting. The Mechanism will continue to focus on ensuring that its	zatvorskom okruženju. Mehanizam de i nadalje biti usredsređen na obezbjeđivanje toga da njegova
implementation of this framework is also reflective of best practices in detention management.	implementacija ovog okvira takođe odražava najbolju praksu zatvorske uprave.
,Third,, in undertaking its enforcement functions,, the Mechanism will continue to rely on the support of Member,	,Trede,, prilikom preduzimanja svojih funkcija sprovođenja kazni,, Mehanizam de nastaviti da se oslanja na podršku,
States and other key stakeholders. It is evident that in order to have an enduring impact on international peace	,država članica i drugih ključnih zainteresovanih subjekata. Očigledno je da,, kako bismo imali trajan uticaj na,
,and justice,, we must all remain committed not only to having trials and appeals and active judicial processes,, but,	,međunarodni mir i pravdu,, moramo svi ostati posvedeni ne samo suđenjima,, žalbenim postupcima i aktivnim,
,also to what comes afterwards. In my six months as President,, I have come to appreciate even more how complex,	,sudskim procesima,, nego i onome što dolazi poslije toga. Za šest mjeseci na dužnosti predsjednika,, još više sam,
,the enforcement of sentences can be,, and how precious such commitment is. In this regard,, I would like to praise,	,shvatio koliko može biti složeno sprovođenje kazni,, te koliko je značajna ta obaveza. U tom pogledu,, želio bih,
the critical role performed by Enforcement States that voluntarily assume additional responsibilities to further the	pohvaliti ključnu ulogu koju obavljaju države sprovođenja kazni koje dobrovoljno preuzimaju dodatne
,cause of international justice. In particular,, I wish to thank Austria,, Benin,, Denmark,, Estonia,, Finland,, France,,,	,odgovornosti radi unapređenja stvari međunarodnog pravosuđa. Konkretno,, želim zahvaliti Austriji,, Beninu,,,
,Germany,, Italy,, Mali,, Norway,, Poland,, Senegal,, Sweden and the United Kingdom for their generosity and ongoing,	,Danskoj,, Estoniji,, Finskoj,, Francuskoj,, Njemačkoj,, Italiji,, Maliju,, Norveškoj,, Poljskoj,, Senegalu,, Švedskoj i,
support with regard to the Mechanism’s enforcement functions.	Ujedinjenom Kraljevstvu za njihovu velikodušnost i trajnu podršku u pogledu funkcija sprovođenja kazni
,This exemplary cooperation is not only vital to the Mechanism’s ability to fulfil its broader mandate,, it is also a,	,Mehanizma. Ova primjerna saradnja je ne samo ključna za sposobnost Mehanizma da sprovede svoj širi mandat,, ona takođe,
sign of the trust and credibility that our institution enjoys in the eyes of the international community. For that	predstavlja znak povjerenja i kredibiliteta koje naša institicija uživa u očima međunarodne zajednice. Iz tog
International Residual Mechanism for Criminal Tribunals	Međunarodni rezidualni mehanizam za krivične sudove
Arusha Tel.: +255 (0)27 256 5376	Arusha Tel: +255 (0)27 256 5376
The Hague Tel.: +31 (0)70 512 5691	Haag Tel: +31 (0)70 512 5691
Email: mict-press@un.org	Email: mict-press@un.org
,Follow us on Facebook,, Twitter,, YouTube,, LinkedIn,	,Pratite nas na Facebooku,, Twitteru,, YouTubeu,, LinkedInu,
www.irmct.org	www.irmct.orgMRMKS
IRMCT	IZJAVA
STATEMENT	PREDSJEDNIK
,PRESIDENT reason,, I am compelled to raise a challenging and most unfortunate situation under the Mechanism’s purview. I,	,razloga,, moram navesti jednu situaciju u nadležnosti Mehanizma koja nam predstavlja izazov i veoma je,
,am referring to the fate of the nine acquitted and released persons that remain in Arusha,, one since 2004,, in an,	,neugodna. Mislim na sudbinu devet osoba koje su oslobođene od optužbi ili puštene na slobodu,, a koje su i dalje,
	,u Arushi,, jedna od njih još od 2004. godine,, u neprihvatljivoj pravnoj neizvjesnosti. Ove osobe bi trebale biti,
,unacceptable legal limbo. These persons should be free to start a new life,, having served their sentences or never,	,slobodne da započnu novi život,, bududi da su izdržale svoje kazne ili nikada nisu ni bile osuđene,, a ipak to ne,
,been convicted in the first place,, and yet they cannot. While the Mechanism is doing all it can to find a long-term,	,mogu. Iako Mehanizam čini sve u svojoj modi da se iznađe dugoročno rješenje,, sudbina ovih devet osoba,
,solution,, the fate of these nine individuals is a responsibility it shares with the Member States of the United,	,predstavlja odgovornost koju on dijeli sa državama članicama Ujedinjenih nacija,, kako je napomenuto u Rezoluciji,
,Nations,, as was noted in Resolution 2422 (2018). More can,, and must,, be done to resolve this situation.,	2422 (2018). Može i mora biti učinjeno više kako bi se razriješila ova situacija.
,Mr President,,,	,Gospodine predsjedniče,,,
It is of course a double pleasure for me to appear before the Security Council on the Day of International Criminal	,Naravno,, dvostruko mi je zadovoljstvo što se pojavljujem pred Savjetom bezbjednosti na Dan međunarodnog,
Justice - a day celebrating the achievements of international criminal courts and tribunals in delivering justice and	krivičnog pravosuđa – dan koji slavi dostignuda međunarodnih krivičnih sudova i tribunala u sprovođenju pravde i
holding to account those responsible for violations of international law. Today we pay tribute to the vision and	utvrđivanju odgovornosti osoba odgovornih za kršenja međunarodnog prava. Danas odajemo počast viziji i
,commitment of all of the individuals,, organisations and stakeholders who have advocated,, and continue to,	,opredjeljenju svih osoba,, organizacija i zainteresovanih strana koji su se zalagali i nastavljaju se zalagati za to da,
,advocate,, for justice to be more than an abstract ideal. The underlying reason for this important day,, namely the,	,pravdu bude više od apstraktnog ideala. Razlog u osnovi ovog značajnog dana,, odnosno usvajanje Rimskog statuta,
,adoption of the Rome Statute of the International Criminal Court,, would not have been possible without the ICTY,	,Međunarodnog krivičnog suda,, ne bi bio mogud bez MKSJ-a i MKSR-a,, koji su utabali stazu za tako izuzetno,
,and the ICTR having paved the way for such a remarkable endeavour. The establishment of the Mechanism,, as,	
,the successor institution to the two ad hoc Tribunals,, further demonstrates the Council’s commitment to,	,dostignude. Osnivanje Mehanizma,, kao institucije koja nasljeđuje dva ad hoc međunarodna suda,, dalje pokazuje,
principled accountability and your resolve to ensure that the closure of the Tribunals will not open the way for	opredijeljenost Savjeta za principijelnu odgovornost i vašu riješenost da obezbijedite da okončanje rada
impunity to reign once more.	međunarodnih sudova ne otvori ponovo put vladavini nekažnjivosti.
On this day we are also called upon to remember that international criminal justice is not the responsibility of	Ovog dana takođe smo pozvani da zapamtimo da međunarodno krivično pravosuđe ne predstavlja odgovornost
courts alone. All those who are committed to the rule of law have a vital part to play in the fight against impunity	samo sudova. Svi oni koji su posvedeni vladavini prava igraju ključnu ulogu u borbi protiv nekažnjivosti – i to
,- and particularly now,, when there is a resurgence in genocide denial and revisionism in both the former,	,naročito sada,, kada ponovo dolazi do negiranja genocida i revizionizma i u bivšoj Jugoslaviji i Ruandi. To,
,Yugoslavia and Rwanda. This includes by defending judicial processes and pronouncements,, and speaking out,	,podrazumijeva odbrani sudskih postupaka i presuda,, te izjašnjavanje protiv onih koji pokušavaju iskriviti istinu,
,against those who try to distort the truth as established by international and domestic courts. Consequently,,,	,koju su utvrdili međunarodni i domadi sudovi. Shodno tome,, one koji negiraju legitimitet zaključaka MKSJ-a,,,
,those who deny the legitimacy of the findings of the ICTY,, the ICTR and the Mechanism must be reminded that,	,MKSR-a i Mehanizma mora se podsjetiti da ste vi,, Savjet bezbjednosti,, povjerili mandat ovim institucijama – i,
,you,, the Security Council,, mandated these institutions – and no-one else – to investigate,, prosecute,, adjudicate,	,nikom drugom – da istraže,, procesuiraju,, presude i izreknu kazne za zločine počinjene u bivšoj Jugoslaviji i Ruandi.,
,and punish the crimes committed in the former Yugoslavia and Rwanda. Likewise,, they must be reminded that,	,Isto tako,, mora ih se podsjetiti da je domadim sudovima povjereno da nastave da sprovode ove funkcije,, a ne,
,the domestic courts are entrusted with continuing to carry out these functions,, and not politicians or individuals. I,	,političarima ili pojedincima. Stoga vas sve pozivam da odbranimo i zaštitimo naše sudsko nasljeđe,, koje je svaki,
,therefore call upon you all to defend and protect our judicial legacy,, which established time and time again,,,	,put van razumne sumnje utvrdilo da je ono što je svijet vidio,, i 1994. i 1995. godine,, predstavljalo genocide,,,
,beyond a reasonable doubt,, that what the world witnessed both in 1994 and in 1995 was genocide,, together with,	zajedno s najtežim i najbrutalnijim drugim međunarodnim zločinima.
the gravest and most brutal of other international crimes.	
,International criminal justice concerns us all,, because justice is in the service of peace,, and peace must be,	,Međunarodno krivično pravosuđe tiče se svih nas,, zbog toga što je pravda u službi mira,, a mir se mora,
,maintained on a daily basis,, as this distinguished Council knows all too well. The extent of the world’s yearning for,	,svakodnevno održavati,, kao što je ovom uvaženom Savjetu isuviše dobro poznato. U kojoj mjeri svijet čezne za,
justice was made clear to me this April when I attended the Twenty-fifth Commemoration of the Genocide	,pravdom postalo mi je jasno ovog aprila u Kigaliju,, kada sam prisustvovao dvadeset petoj komemoraciji genocida,
,against the Tutsi,, in Kigali,, and again last week in Potočari where I attended the Twenty-fourth Commemoration,	,protiv Tutsija,, te ponovo prošle sedmice u Potočarima,, gdje sam prisustvovao dvadeset četvrtoj komemoraciji,
,of the Srebrenica Genocide. These occasions reinforced in me the firm belief that,, while international justice takes,	,genocida u Srebrenici. Ove prilike učvrstile su me u snažnom uvjerenju da,, iako je za međunarodnu pravdu,
,time and costs money,, for the victims and affected communities it is worth it,, offering not only some form of,	,potrebno vremena i novca,, ona je za žrtve i pogođene zajednice vrijedna toga,, jer nudi ne samo određeni oblik,
,closure but also a powerful way forward. However,, we must be mindful that justice has enemies as well,,,	,razriješenja nego i modan put naprijed. Međutim,, moramo biti svjesni da pravda ima i neprijatelje,, koji konstantno,
constantly seeking to make sure that countless atrocities throughout the globe remain unanswered.	nastoje da spriječe da se odgovori na bezbrojna zvjerstva širom globusa.
,Mr President,,,	,Gospodine predsjedniče,,,
I am determined to do my utmost to maximise the Mechanism’s ability to deliver meaningful justice and to fulfil	Riješen sam da učinim sve u svojoj modi kako bi se do maksimuma dovela sposobnost Mehanizma da donese
all aspects of its mandate in an effective and efficient manner. My Colleagues the other Judges and the	,smislenu pravdu i ispuni sve aspekte svog mandata na efektivan i efikasan način. Moje kolege,, druge sudije i,
International Residual Mechanism for Criminal Tribunals	Međunarodni rezidualni mehanizam za krivične sudove
Arusha Tel.: +255 (0)27 256 5376	Arusha Tel: +255 (0)27 256 5376
The Hague Tel.: +31 (0)70 512 5691	Haag Tel: +31 (0)70 512 5691
Email: mict-press@un.org	Email: mict-press@un.org
,Follow us on Facebook,, Twitter,, YouTube,, LinkedIn,	,Pratite nas na Facebooku,, Twitteru,, YouTubeu,, LinkedInu,
www.irmct.org	www.irmct.orgMRMKS
IRMCT	IZJAVA
STATEMENT	PREDSJEDNIK
,PRESIDENT Mechanism’s Principals,, together with our exceptional staff,, are equally committed to this task. However,, we,	,čelnici Mehanizma,, zajedno s našim izuzetnim osobljem,, podjednako su posvedeni tom zadatku. Međutim,, ne,
,cannot do it alone. The success of international justice depends on sustained support and cooperation,, today and,	,možemo to činiti sami. Uspjeh međunarodnog pravosuđa ovisi o trajnoj podršci i saradnji,, danas i svakoga dana.,
,every day. I hope,, and trust,, that the Mechanism will continue to find such help in the esteemed Member States,	Nadam se i vjerujem da de Mehanizam nastaviti da nailazi na takvu pomod cijenjenih država članica ovog Savjeta.
,of this Council. For your support thus far,, I am extremely thankful.,	Za vašu dosadašnju podršku izuzetno sam zahvalan.
,Before concluding,, please allow me,, Mr President,, to commend you on your Presidency for the month of July and,	,Prije nego što zaključim,, molim vas dopustite mi,, g. predsjedniče,, da vas pohvalim za vaše predsjedavanje za juli,
to thank you in particular for your personal commitment and outstanding leadership as Chair of the Council’s	mjesec i da vam naročito zahvalim za ličnu posvedenost i izvrsno liderstvo u svojstvu predsjedavajudeg
Informal Working Group on International Tribunals. My recognition also goes to the Office of Legal Affairs and its	Neformalne radne grupe Savjeta za međunarodne sudove. Moje priznanje takođe ide Službi za pravne poslove i
dedicated team for their invaluable support.	njenom posvedenom timu za njihovu dragocjenu podršku.
,And last but not least,, I wish to express my sincere gratitude for the continuing and excellent support provided by,	,I na kraju,, ali ne i najmanje važno,, želim izraziti iskrenu zahvalnost za kontinuiranu i izvrsnu podršku koju pružaju,
,the two Host Countries of the Mechanism,, the Kingdom of the Netherlands and the United Republic of Tanzania.,	,dvije države domadini Mehanizma,, Kraljevina Nizozemska i Ujedinjena Republika Tanzanija.,
Thank you for your attention.	Hvala vam na pažnji.
International Residual Mechanism for Criminal Tribunals	Međunarodni rezidualni mehanizam za krivične sudove
Arusha Tel.: +255 (0)27 256 5376	Arusha Tel: +255 (0)27 256 5376
The Hague Tel.: +31 (0)70 512 5691	Haag Tel: +31 (0)70 512 5691
Email: mict-press@un.org	Email: mict-press@un.org
,Follow us on Facebook,, Twitter,, YouTube,, LinkedIn,	,Pratite nas na Facebooku,, Twitteru,, YouTubeu,, LinkedInu,
www.irmct.org	www.irmct.org
