Annual accounts for 2017	Comptes anuals 2017
(Together with audit report)	(juntament amb l'informe d’auditoria)
PUBLIC AUDIT REPORT OF THE ANNUAL ACCOUNTS OF THE BARCELONA CITY COUNCIL OF RELATED YEAR 20171	INFORME D'AUDITORIA PÚBLICA DELS COMPTES ANUALS DE L'AJUNTAMENT DE BARCELONA CORRESPONENTS A L'EXERCICI 2017
To the Municipal Council of the Barcelona City,	Al Consell Municipal de l'Ajuntament de Barcelona,
I. Introduction	I. Introducció
We have audited the accompanying annual accounts of the Barcelona City Council, in order to the standards of Public Sector, which comprise the balance sheet as at December 31, 2017, the income statement, the statement of changes in equity, the cash flow statement, the budget implementation statement and the notes thereto for the year then ended.	Hem realitzat, d'acord amb les Normes d’Auditoria del Sector Públic, l'auditoria dels comptes anuals adjunts de l'Ajuntament de Barcelona (en endavant l'Ajuntament) que comprenen el balanç a 31 de desembre de 2017, el compte del resultat econòmic-patrimonial, l'estat de canvis en el patrimoni net, l'estat de fluxos d'efectiu, l'estat de liquidació del pressupost i la memòria corresponents a l'exercici anual acabat en aquesta data.
This audit has been carried out in accordance with the provisions of section 58.e) and 74 of Law 1/2006, of 13 March 2006, regulating the special regime of the municipality of Barcelona, and the stipulations of the administrative clauses and technical specifications of the contract for the provision of audit services for the individual and consolidated annual accounts of the Barcelona City Council and its municipal economic Group.	Aquesta auditoria ha estat realitzada dins del marc que preveuen els articles 58.e) i 74 de la Llei 1/2006, de 13 de març, per la qual es regula el règim especial del municipi de Barcelona i l’establert als Plecs de Clàusules Administratives Particulars i Tècniques del contracte de serveis d'auditoria dels comptes anuals de l'Ajuntament de Barcelona i del seu grup municipal.
The municipal manager is responsible for the preparation of these annual accounts in accordance with the criteria for financial reporting described in note 3.1 of the accompanying notes and, specifically, with the conceptual framework of public accounting and recognition and valuation rules includes on the Order HAP/1781/2013, of 20th September, by which the Instruction of the normal model of the local accounting is approved.	El Gerent Municipal és responsable de la formulació dels comptes anuals de l'Ajuntament d'acord amb el marc d'informació financera que es detalla a la nota 3.1 de la memòria adjunta i en particular, amb el marc conceptual de la comptabilitat pública i les normes de reconeixement i valoració incloses en la Ordre HAP/1781/2013, de 20 de setembre, per la qual s'aprova la Instrucció del Model Normal de Comptabilitat Local.
The annual accounts which this report refers to have been prepared by the manager on 23 May 2018.	Els comptes anuals a què es refereix aquest informe han estat formulats pel Gerent Municipal en data 23 de maig de 2018.
II. Purpose and scope of the work: Auditor's responsibility	II. Objectiu i abast del treball: responsabilitat de l'auditor
Our responsibility is to express an opinion on whether the accompanying annual accounts of the Barcelona City Council give a true and fair view based on the work that we have carried out in accordance with the auditing standards of the public sector, as well as the results of the operations reflected in the economic-equity income statement and in the budget settlement, and of the resources obtained and applied during the year, and contain the information necessary for its interpretation and adequate understanding.	La nostra responsabilitat és emetre una opinió, basada en el treball realitzat, d'acord amb les Normes d'Auditoria del Sector Públic, sobre si els comptes anuals adjunts de l'Ajuntament expressen, en tots els seus aspectes significatius, la imatge fidel del seu patrimoni i de la seva situació financera, així com dels resultats de les seves operacions reflectides en el compte del resultat econòmic-patrimonial i en la liquidació del pressupost, i dels recursos obtinguts i aplicats durant l'exercici, i contenen la informació necessària per a la seva interpretació i comprensió adequada.
1 This report is a translation of the Barcelona City Council public audit report un the annual accounts for the year ended on December 31st, 2017 which is issued in Catalan in May 30th, 2018. Any opinion must be referred to the abovementioned Catalan audit report version. Only the audit report issued in Catalan is authentic, and is accompanied by the annual accounts.	Atès el caràcter limitatiu del pressupost de despeses de l'entitat l'objectiu de l'auditoria inclou la verificació del compliment en els aspectes mes significatius de les normes pressupostàries especialment el compliment de les regles pressupostàries de limitació quantitativa, qualitativa i temporal i les relatives a modificacions pressupostàries.
In view of the limiting nature of the entity's expenditure budget the objective of the audit includes verification of compliance in the most significant aspects of the budgetary rules in particular compliance with the quantitative, qualitative and temporal limits of budgetary rules and those related to budget modifications.	
Those standards require that we plan and perform the audit to obtain a reasonable assurance, but not absolute, about whether the annual accounts are free from material misstatement.	Aquestes normes exigeixen que planifiquem i executem l'auditoria per tal d'obtenir una seguretat raonable, tot i que no absoluta, que els comptes anuals estan lliures d'incorreccions materials.
An audit requires performing procedures to obtain audit evidence about the amounts and information in the annual accounts. The procedures selected depend on the auditor's judgment, including the assessment of the risks of material misstatement of the annual accounts. In making those risk assessments, the auditor considers internal control relevant to entity's preparation of annual accounts in order to design audit procedures that are appropriate in the circumstances, but not for the purpose of expressing an opinion on the effectiveness of the entity's internal control. An audit also includes evaluating the appropriateness of accounting policies used and the reasonableness of accounting estimates made by management, as well as evaluating the overall presentation of the annual accounts.	Una auditoria financera comporta l'aplicació de procediments per obtenir evidència adequada i suficient sobre els imports i la informació recollida en els comptes anuals. Els procediments seleccionats depenen del judici de l'auditor, inclosa la valoració dels riscos d'incorrecció material en els comptes anuals. En efectuar aquestes valoracions del risc, l'auditor té en compte el control intern rellevant per a la preparació i presentació raonable per part del gestor de comptes anuals, a fi de dissenyar els procediments d'auditoria que siguin adequats en funció de les circumstàncies, i no amb la finalitat d'expressar una opinió sobre l'eficàcia del control intern de l'entitat. Una auditoria financera també inclou l'avaluació de l'adequació dels criteris comptables i de la raonabilitat de les estimacions comptables realitzades pel gestor, així com l'avaluació de la presentació global dels comptes anuals.
We believe that the audit evidence we have obtained is sufficient and appropriate to provide a basis for our audit opinion.	Considerem que l'evidència d'auditoria que hem obtingut proporciona una base suficient i adequada per emetre la nostra opinió d'auditoria.
III. Audit opinion	III.Opinió d'auditoria
In our opinion, the accompanying annual accounts present fairly, in all material respects, of the equity and financial position of the Barcelona City Council at December 31, 2017 and the results of its operations, cash flows and budget settlement statement for the year then ended, in accordance with applicable regulatory framework for financial information and with the budgetary regulations applicable and, specifically, the conceptual framework of public accounting and the recognition and valuation rules contained therein.	Segons la nostra opinió, els comptes anuals adjunts expressen, en tots els aspectes significatius, la imatge fidel del patrimoni i de la situació financera de l'Ajuntament de Barcelona a 31 de desembre de 2017, així com del seu resultat econòmic - patrimonial, fluxos d'efectiu i de la liquidació del pressupost corresponents a l'exercici anual acabat en aquesta data, de conformitat amb el marc normatiu d'informació financera i amb la normativa pressupostària que resulta d'aplicació i, en particular, amb el marc conceptual de la comptabilitat pública i les normes de reconeixement i valoració contingudes en el mateix.
ERNST & YOUNG, S.L.	ERNST & YOUNG, S.L,
Alejandro Martínez Gómez	Alejandro Martínez Gómez
May 30, 2018	Barcelona, 30 de maig de 2018
1 This report is a translation of the Barcelona City Council public audit report un the annual accounts for the year ended on December 31st, 2017 which is issued in Catalan in May 30th, 2018. Any opinion must be referred to the abovementioned Catalan audit report version. Only the audit report issued in Catalan is authentic, and is accompanied by the annual accounts.	
Balance sheet as of 31 December 2017 (amounts in euros)	Balanç a 31 de desembre de 2017 (imports en euros)
Balance sheet as of 31 December 2017 (amounts in euros)	Balanç a 31 de desembre de 2017 (imports en euros)
Income and expenditure account as of 31 December 2017 (amounts in euros)	Compte del resultat econòmic patrimonial a 31 de desembre de 2017 (imports en euros)
Statement of changes in net equity (amounts in euros)	Estat de canvis en el patrimoni net (imports en euros)
1. Total statement of changes in net equity	1. Estat total de canvis en el patrimoni net
2. Statement of recognised income and expenditure	2. Estat d'ingressos i despeses reconeguts
Cash-flow statement (amounts in euros)	Estat de fluxos d'efectiu (imports en euros)
Budget implementation statement (amounts in euros)	Estat de liquidació del pressupost (imports en euros)
1. Expenditure budget implementation	1. Liquidació del pressupost de despeses
2. Income budget settlement	2. Liquidació del pressupost d'ingressos
Budget implementation statement (amounts in euros)	Estat de liquidació del pressupost (imports en euros)
3. Budgetary results for 2017	3. Resultat pressupostari
ANNUAL REPORT FOR THE 2017 FINANCIAL YEAR	MEMÒRIA DE L'EXERCICI 2017 1. Organització i activitat
1. Organisation and activity	1.1. Població oficial i dades de caràcter socioeconòmic
	Barcelona, amb una superfície de 101,35 km2, és la capital de Catalunya i la segona ciutat de l'Estat espanyol per població. La població oficial de la ciutat de Barcelona a 1 de gener de 2017 és de 1.620.809 habitants, segons dades publicades per
	l'Institut Nacional d'Estadística, un 0,7% més que l'any anterior. A Barcelona hi
1.1. Official population and socio-economic data	conviuen persones de 166 nacionalitats, sent la població estrangera recollida al
Barcelona, which covers an area of 101.35 km2, is the capital of Catalonia and the second largest city in Spain in population terms. The official number of city residents on 1 January 2017 was 1,620,809, according to data published by the National Institute of Statistics, representing an increase of 0.7% on the previous year. There are 166 nationalities in that total and the number of registered foreign residents on 1 January 2017 came to 288,675. Barcelona is part of the Barcelona Metropolitan Area, Barcelonés County Council and Barcelona Provincial Council.	padró a 1 de gener de 2017 de 288.675 persones. La ciutat de Barcelona forma part de l'Àrea Metropolitana de Barcelona, del Consell Comarcal del Barcelonès i de la Diputació de Barcelona.
The city's economy is essentially tertiary. According to the latest data published on Barcelona's GNP, that sector represents 89.6% of the gross added value (15 percentage points above the Catalan figures), to the detriment of industry (7.4%), construction (2.9%) and the primary sector (0.1%). As regards the sectoral distribution of actively employed people registered with Social Security, on 31 December 2017 the percentage of workers employed in each sector was 90% in social services; 6.9% in industry; 3% in construction and the remaining 0.1% in agriculture, livestock and fisheries.	L'economia de la ciutat és fonamentalment terciària. El pes d'aquest sector, d'acord amb les darreres dades publicades del PIB de Barcelona, representa el 89,6% del valor afegit brut (15 punts percentuals per sobre dels valors catalans), en detriment de la indústria (7,4%), la construcció (2,9%) i el sector primari (0,1%). Pel que fa a la distribució sectorial dels ocupats afiliats a la Seguretat Social, a 31 de desembre de 2017 el sector serveis ocupava el 90% dels treballadors, la indústria el 6,9%, la construcció el 3,0% i l'agricultura, ramaderia i pesca el 0,1% restant.
The following table shows the main economic activity indicators for Barcelona and its metropolitan area for 2017.	La taula següent mostra els principals indicadors de l'activitat econòmica de
1.2. Description of the main sources of revenue	Barcelona i el seu àmbit metropolità referents a l'any 2017.
The main sources of revenue for both Barcelona City Council and the other local	1.2. Descripció de les principals fonts d'ingressos
authorities are regulated by Spanish Royal Legislative Decree 2/2004 of 5 March, approving the consolidated text of the Regulatory Act on Local Tax Offices (Royal Legislative Decree 2/2004 (LHRL). The details of Barcelona City Council's main	Les principals fonts d'ingressos, tant de l'Ajuntament de Barcelona com de la resta de municipis, es troben regulades pel Reial Decret Legislatiu 2/2004, de 5 de març, pel que s'aprova el text refós de la Llei reguladora de les Hisendes Locals (Reial
day-to-day management income for 2017 were as follows:	Decret Legislatiu 2/2004 LRHL). Per l'any 2017, el detall del principals ingressos de gestió ordinària de l'Ajuntament de Barcelona ha estat el següent:
1.3. City Council's Tax Treatment	1.3. Consideració fiscal de l'Ajuntament
a) Corporation Tax	a) Impost de Societats
Barcelona City is exempt from corporation tax and its capital furniture gains are not subject to deduction, under Act 27/2014, of 27 November, on Corporation Tax	En aplicació de la Llei 27/2014, de 27 de novembre, de l'Impost sobre Societats, l'Ajuntament de Barcelona està exempt de l'impost i els rendiments del seu capital mobiliari no estan subjectes a retenció.
b) Value Added Tax (VAT)	b) Impost sobre el Valor Afegit (IVA)
For the purposes of VAT, the City Council carries out transactions that are either subject to this tax (business activities) or not (public activities). As regards the VAT deduction system, it has opted for the special pro rata basis.	L'Ajuntament realitza a efectes de l'IVA operacions que no es troben subjectes (activitats Públiques ) i operacions subjectes (activitats empresarials). Pel que fa al règim de deduccions de les quotes d'IVA suportades ha optat per la modalitat de prorrata especial.
1.4. Basic organisational, political and administrative structure	1.4. Estructura organitzativa bàsica, en els seus nivells polític i
Barcelona City Council's basic organisational, political and administrative structure is as follows:	administratiu L'estructura organitzativa bàsica de l'Ajuntament de Barcelona, en els seus nivells polític i administratiu és la següent:
1.4.1. Political organisation	1.4.1. Organització política
Municipal elections are held every four years, under a proportional representation system. As a result of the last elections, held on 24 May 2015, the current composition of the Municipal Council is as follows:	Les eleccions municipals se celebren cada quatre anys, d'acord amb un sistema de representació proporcional. Com a resultat de les últimes eleccions, celebrades el 24 de maig de 2015, la composició actual del Consell Municipal és la següent:
On 31 December 2017, the 11 Barcelona en Comú councillors formed the municipal government. The agreement with the Partit dels Socialistes de Catalunya -Candidatura de Progrés, which was signed in May 2017 and led to four Partit dels Socialistes de Catalunya - Candidatura de Progrés councillors joining the municipal government, was terminated in November 2017.	El govern municipal el composen, a 31 de desembre de 2017, els 11 regidors de Barcelona en Comú. L'acord de govern amb el Partit dels Socialistes de Catalunya - Candidatura de Progrés, signat el maig del 2016 i que va suposar a incorporació al govern municipal dels 4 regidors del Partit dels Socialistes de Catalunya -Candidatura de Progrés és va trencar el novembre de 2017.
The political area is made up of the various government, city and territorial bodies. The political structure is as follows:	L'àmbit polític el constitueixen els diferents òrgans de govern, de ciutat i territorials. L'estructura política és la següent:
1.4.2. Administrative organisation	1.4.2. Organització administrativa
	L'organització administrativa o executiva de l'Ajuntament de Barcelona, dirigida
Barcelona City Council's administrative or executive organisation, which is run and coordinated by the municipal manager, is made up, on the one hand, of sectors and districts, which are divisions and bodies integrated into the City Council's single legal personality, run by managers appointed by the Mayor. On the other hand, we have local independent bodies, public business entities and trading companies, which have their own separate legal personalities but are functionally dependent on their sectors of activity.	i coordinada pel gerent municipal, la componen, d'una banda els sectors i districtes, que són divisions i òrgans integrats en la personalitat jurídica única de l'Ajuntament, dirigits per gerents nomenats per l'alcalde; i de l'altra organismes autònoms locals, entitats públiques empresarials i societats mercantils, que són òrgans dotats de personalitat jurídica diferenciada, però amb dependència funcional del seu sector d'activitat.
This managerial structure is tasked not just with ensuring the services provided by Barcelona City Council are effective and efficient and meet the city's values and needs, but also with seeing to the planning, organisation and provision of public services, to make sure the goals set out under the Municipal Action Plan are achieved.	Aquesta estructura gerencial s'encarrega que els serveis prestats per l'Ajuntament de Barcelona als ciutadans siguin eficaços i eficients, i responguin als valors i a les necessitats de la ciutat, alhora que es fa càrrec de la planificació, organització i prestació dels serveis públics, per garantir l'acompliment dels objectius que expressa el pla d'actuació municipal.
The following organisation chart shows Barcelona City Council's administrative structure:	El següent organigrama mostra l'estructura administrativa de l'Ajuntament de Barcelona:
1.5. Average number of employees during the financial year and on 31 December, both civil servants and externally contracted staff, according to category and sex	1.5. Nombre mig d'empleats durant l'exercici i a 31 de desembre, tant funcionaris com personal laboral, distingint per categories i sexes.
1.5.1. Average number of employees during 2017	1.5.1. Nombre mig d'empleats durant el 2017
1.5.2. Number of employees on 31/12/2017	1.5.2. Nombre d'empleats a 31/12/2017
1.6. Entities of the group, multi-group and associate bodies	1.6. Entitats del grup, multigrup i associades
1.6.1. Group entities	1.6.1. Entitats del grup
1.6.2. Multi-group entities	1.6.2. Entitats multigrup
a) Entities that are consolidated with the City Council	a) Entitats que consoliden amb l'Ajuntament
b) Entities excluded from municipal consolidation	b) Entitats excloses de la consolidació municipal
1.6.3. Associated entities	1.6.3. Entitats associades
2. Indirect management of public services, agreements and other forms of collaboration	2. Gestió indirecta de serveis públics, convenis i altres formes de col·laboració
The powers and services provided by the City Council are as follows:	Les competències i serveis que presta l'Ajuntament són:
a) Mandatory services:	a) Serveis obligatoris:
The City Council provides the following mandatory services: public lighting, cemeteries, urban environment, waste collection, waste treatment, street cleaning, household supply of drinking water, sewers, access to city centres, road surfacing, public parks, public libraries, civil protection, assessing and providing information on situations of social need and immediate care for people in situations of social risk, preventing and extinguishing fires, public sports facilities and urban public passenger transport.	L'Ajuntament presta els següents serveis obligatoris: enllumenat públic, cementiri, medi ambient urbà, recollida de residus, tractament de residus, neteja viària, abastament domiciliari d'aigua potable, clavegueram, accés als nuclis de població, pavimentació de les vies públiques, parc públic, biblioteca pública, protecció civil, avaluació i informació de situacions de necessitat social i l'atenció immediata a persones en situació o risc d'exclusió social, prevenció i extinció d'incendis i instal·lacions esportives d'ús públic, i transport col·lectiu urbà de viatgers.
b) Voluntary services:	b) Serveis voluntaris:
The supplementary services provided by the City Council include the following: nursery schools, vehicle parking, promotion of culture and cultural facilities, work promotion services, etc.	Com a serveis complementaris, l'Ajuntament també presta, entre d'altres, els següents: escoles bressols, estacionament de vehicles, promoció de la cultura i equipaments culturals, serveis de foment del treball, etc.
Most of these services are provided directly by the City Council and others through its subsidiary organisations.	La majoria d'aquests serveis són prestats de manera directa per l'Ajuntament i altres a través de algun dels seus ens dependents.
As for indirect management of public services, the most important contracts are: • Household supply of drinking water.	Pel que fa a la gestió indirecta dels serveis públics, els contractes més significatius són:
• Waste water disposal and treatment.	• Abastament domiciliari d'aigua potable.
• Underground vehicle parking.	• Evacuació i tractament d'aigües residuals.
• Public passenger transport.	• Estacionament de vehicles en el subsòl.
The Barcelona Metropolitan Area (AMB), as the Local Entity, is responsible	• El transport públic de viatgers.
for supplying household water to the city of Barcelona, as set out in Spanish	El servei d'abastament d'aigua domiciliària de la ciutat de Barcelona és
Legislative Decree 3/2003 of 4 November. The AMB provides that service through a semi-public company called Aigües de Barcelona, Empresa Metropolitana de Gestió del Cicle Integral de l'Aigua SA, made up by Aigües de Barcelona (70%); Criteria (15%) and the AMB (15%). The company uses the municipally owned assets allocated to the service when it was incorporated. Barcelona's disposal and treatment of waste water falls under the jurisdiction of	competència de l'Àrea Metropolitana de Barcelona (AMB) com a Ens Local tal i com s'estableix en el Decret legislatiu 3/2003, del 4 de novembre. Aquesta dóna el servei a través d'una societat de capital mixt anomenada Aigües de Barcelona, empresa metropolitana de gestió del cicle integral de l'aigua SA, formada per la Societat General d'Aigües de Barcelona (70%); Criteria (15%) i l'AMB (15%). La societat utilitza els béns de propietat municipal afectes al servei en el moment de la constitució.
the Barcelona Metropolitan Area as the Local Entity and established as such under Legislative Decree 3/2003 of 4 November. The AMB provides that service through a semi-public company called Aigües de Barcelona, Empresa Metropolitana de Gestió del Cicle Integral de l'Aigua SA, made up by Aigües de Barcelona (70%); Criteria (15%) and the AMB (15%). The company uses the municipally owned assets allocated to the service when it was incorporated.	El servei d'evacuació i tractament d'aigües residuals de la ciutat de Barcelona es competència de l'Àrea Metropolitana de Barcelona com a Ens Local tal i com s'estableix en el Decret legislatiu 3/2003, del 4 de novembre. Aquesta dóna el servei a través d'una societat de capital mixt anomenada Aigües de Barcelona, empresa metropolitana de gestió del cicle integral de l'aigua SA, formada per la Societat General d'Aigües de Barcelona (70%); Criteria (15%) i l'AMB (15%). La societat utilitza els béns de propietat municipal afectes al servei en el moment de la constitució.
The vehicle parking service is managed directly for street-level parking and indirectly for underground parking. Underground parking spaces and, more specifically, those located in Barcelona's	El servei d'estacionament de vehicles es gestiona de forma directa pel que fa a aquells aparcaments en superfície, i de manera indirecta per aquells aparcaments situats en el subsòl.
city centre (central perimeter), are managed indirectly through a mixed- economy company in the form of a public limited company (SA) called Barcelona d'Aparcaments Municipals, SA (BAMSA), owned by Saba Car Park, SL (60%) and BSM (40%). The company was incorporated for a 25-year period and uses the municipally owned assets allocated to the service at the time of its incorporation. The public passenger transport service is managed by the Metropolitan Transport Authority (ATM), which was created as a voluntary inter-administrative consortium and set up in the 1997 financial year. The consortium is made up of the following authorities: the Generalitat [regional government] of Catalonia (51 %) and local authorities (49%), the latter consisting of Barcelona City Council, the Barcelona Metropolitan Area (AMB) and the Association of Municipalities for Mobility and	Pel que fa a la gestió indirecta dels aparcaments situats en el subsòl, i en concret els ubicats al centre de la ciutat de Barcelona (perímetre central), són gestionats de forma indirecta per mitjà d'una societat d'economia mixta amb la forma de societat anònima i el nom de Barcelona d'Aparcaments Municipals, SA (BAMSA) formada per Saba Car Park, SL (60%) i BSM (40%). La societat fou constituïda per un termini de 25 anys, i utilitza els béns de propietat municipal afectes al servei en el moment de la constitució.
Urban Transport (AMTU). The contributions made to this consortium by the City Council during the 2017 financial year under the ATM's four-year plan (2014-2017) came to €136.67 million.	El servei de transport públic de viatgers es gestiona mitjançant l'Autoritat del Transport Metropolità (ATM), creat com un consorci interadministratiu de caràcter voluntari, constituït en l'exercici 1997. Les administracions consorciades són la Generalitat de Catalunya (51 %) i administracions locals (49 %), que són l'Ajuntament de Barcelona, l'Àrea Metropolitana de Barcelona (AMB) i l'Associació de Municipis per la Mobilitat i el Transport Urbà (AMTU). Les aportacions efectuades per l'Ajuntament en l'exercici 2017 a aquest consorci en virtut del pla quadriennal 2014-2017 de l'ATM han estat de 136,67 milions d'euros.
3. Bases of presentation of the accounts	3. Bases de presentació dels comptes
3.1. A true and accurate picture	3.1. Imatge fidel
These annual accounts have been obtained from the Municipal Corporation's	
accounting records as of 31 December 2017 and are presented under current accounting provisions legally in force, for the purposes of showing a true and accurate picture of the equity and the financial situation on the date mentioned herein, of the income and expenditure, of the statement of changes in net equity, of the cash flow, of the results of the implementation of the budget, for the financial year ending on that date, which are expressed in euros. These annual accounts will be part of Barcelona City Council's General Accounts, which will be submitted for approval at the Full Municipal Council Meeting within	Els comptes anuals s'han obtingut dels registres comptables de la Corporació tancats a 31 de desembre de 2017, i es presenten d'acord amb les disposicions legals vigents en matèria comptable, amb l'objecte de mostrar la imatge fidel del patrimoni i de la situació financera a la data esmentada, del resultat econòmic-patrimonial, dels canvis en el patrimoni net, dels fluxos d'efectiu, i del resultat de l'execució del pressupost, corresponents a l'exercici anual acabat en la mateixa data, els quals s'expressen en euros.
the legal deadlines established. The budget settlement was approved by Mayoral Decree on 28 February 2018.	Aquests comptes anuals formaran part del Compte General de l'Ajuntament de Barcelona, el qual serà sotmès a l'aprovació del Plenari del Consell Municipal en els terminis legals establerts. La liquidació del pressupost ha estat aprovada per Decret d'alcaldia el 28 de febrer de 2018.
The City Council's accounting system is the one provided for under the Act on Local Tax Offices for local entities and their independent bodies. The annual	El règim de comptabilitat de l'Ajuntament és el previst en la Llei reguladora de les Hisendes Locals per a les entitats locals i els seus organismes autònoms.
accounts for the 2017 financial year were prepared in accordance with Order	Els comptes anuals de l'exercici 2017 han estat elaborats d'acord amb l'Ordre
HAP/1781/2013 of 20 September, approving the Guidelines of the Local Standard	HAP/1781/2013, de 20 de setembre, per la qual s'aprova la Instrucció del model
Accounting Model (henceforth the IMNCL), and with the provisions set out in	normal de comptabilitat local (endavant, la IMNCL), així com amb el que preveu
the General Public Accounting Plan adapted for Local Authorities (PGCPAL)	el Pla General de Comptabilitat Pública adaptat a l'Administració Local (PGCPAL)
accompanying the IMNCL.	que acompanya la IMNCL.
The following current legislation has also been taken into account:	Addicionalment s'ha considerat la següent legislació vigent:
• Act 7/1985 of 2 April, regulating local government.	• Llei 7/1985, de 2 d'abril, reguladora de les bases de règim local.
• Royal Decree Law 781/1986 of 18 April, approving the consolidated text of	• Reial decret llei 781/1986, de 18 d'abril, pel qual s'aprova el text refós de
current provisions on local government.	disposicions vigents en matèria de règim local.
• Legislative Decree 2/2003 of 28 April, approving the consolidated text of the Municipal and Local Government Act of Catalonia.	• Decret legislatiu 2/2003, de 28 d'abril, pel qual s'aprova el Text refós de la Llei municipal de règim local de Catalunya.
• Royal Legislative Decree 2/2004 of 5 March, approving the consolidated text of the regulatory Act on Local Tax Offices (Act 39/1988 of 28 December).	• Reial decret legislatiu 2/2004, de 5 de març, pel qual s'aprova el Text refós de la Llei reguladora de les hisendes locals (Llei 39/1988, de 28 de desembre).
• Royal Decree 500/1990 of 20 April, developing Chapter I of Title VI of Act 39/1998 of 28 December, regulating budgets in local tax offices.	• Reial decret 500/1990, de 20 de abril, pel qual es desenvolupa el capítol primer del títol sisè de la Llei 39/1998, de 28 de desembre, reguladora de les hisendes locals en matèria de pressupostos.
• Documents on accounting principles issued by the Commission on Public Account Principles and Standards, created by Ministerial Order by the Secretary of State for Treasury on 28 December 1990.	• Documents sobre principis comptables emesos per la Comissió de Principis i Normes Comptables Públiques, creada per Resolució de la Secretaria d'Estat d'Hisenda de 28 de desembre de 1990.
• Order of 27 April 2007 on the implementation of Decree 94/1995 of 21 February, as amended by ministerial decrees ECF/2901/2008, ECF/1769/2009, ECF/3210/2010, ECO/1406/2011, ECO/2829/2012 and ECO/2876/2014 on the	• Ordre de 27 d'abril de 2007, sobre desplegament del Decret 94/1995 de 21 de febrer, modificada per les resolucions ECF/2901/2008, ECF/1769/2009, ECF/3210/2010, ECO/1406/2011, ECO/2829/2012 i ECO/2876/2014 en matèria de tutela financera dels ens locals.
financial supervision of local entities. • Act 15/2010 of 5 July, on the amendment of Act 3/2004 of 29 December, establishing measures against arrears in commercial transactions.	• Llei 15/2010, de 5 de juliol, de modificació de la Llei 3/2004, de 29 de desembre, per la qual s'estableixen mesures de lluita contra la morositat a les operacions comercials.
• Framework Act 2/2012 of 27 April, on budget stability and financial sustainability, with amendments introduced by Framework Act 9/2013 of 20 December, on controlling commercial debt in the public sector.	• Llei orgànica 2/2012, de 27 d'abril, d'estabilitat pressupostària i sostenibilitat financera, amb les modificacions introduïdes per la Llei orgànica 9/2013, de 20 de desembre, de control del deute comercial en el sector públic.
• Framework Act 9/2013 of 20 December, on controlling commercial debt in the public sector.	• Llei Orgànica 9/2013, de 20 de desembre, de control del deute comercial en el sector públic.
• Act 27/2013 of 27 December, on the rationalisation and sustainability of local authorities.	• Llei 27/2013, de 27 de desembre, de racionalització i sostenibilitat de l'administració local.
Furthermore, the Barcelona Municipal Charter, which was approved by Act 1/2006 of 13 March, regulates, among other things, municipal powers, the organisation of the Municipal Government, the districts, the organisation of the municipal	Per altra part, la Carta Municipal de Barcelona, aprovada per Llei 1/2006, de 13 de març, regula, entre d'altres matèries, les competències municipals, l'organització del govern municipal, els districtes, l'organització municipal executiva i la
	participació ciutadana. L'aplicació dels principis i criteris comptables està presidida per la consideració de la importància en termes relatius que aquests i els seus efectes poden presentar. Per consegüent, és admissible la no aplicació estricta d'algun d'aquests, sempre que la importància relativa en termes quantitatius o qualitatius de la variació
executive and public participation.	constatada sigui escassament significativa i no alteri, per tant, la imatge fidel de
The accounting principles and criteria applied are heavily influenced by	la situació patrimonial i dels resultats. Les partides o els imports la importància
consideration of the importance they and their effects may have in relative terms.	relativa dels quals sigui escassament significativa poden aparèixer agrupats amb
As a result, they do not need to be strictly applied, provided that the relative	altres de similar naturalesa o funció.
quantitative or qualitative importance of the variation recorded is hardly significant and does not therefore affect the true and accurate picture of the net equity situation and the income and expenditure. Entries and amounts whose relative importance is scarcely significant may appear grouped together with others of a similar nature or function.	No existeixen raons excepcionals per les quals, per assolir els objectius anteriors,
There are no exceptional reasons, for the purposes of achieving the above goals,	no s'hagin aplicat disposicions legals en matèria comptable.
for current accounting provisions legally in force not to have been applied.	L'Ajuntament formula comptes anuals consolidats que integren els comptes
The City Council prepares consolidated annual accounts that include the accounts of the City Council, the group's entities (local independent bodies, publicly owned business entities and subsidiary trading companies), multi-group entities and	de l'Ajuntament, de les entitats del grup (organismes autònoms locals, entitats públiques empresarials i societats mercantils dependents), de les entitats
associated entities.	multigrup i entitats associades.
3.2. Comparison of the information	3.2. Comparació de la informació
The annual accounts for the financial years 2017 and 2016 were drawn up in accordance with the framework established under the IMNCL, and prepared under uniform valuation, grouping, classification and monetary-unit criteria. As a result, the information presented is homogeneous and comparable.	Els comptes anuals dels exercicis 2017 i 2016 s'han formulat d'acord amb la estructura establerta a la IMNCL, havent seguit en la seva elaboració l'aplicació de criteris uniformes de valoració, agrupació, classificació i unitats monetàries, de manera que la informació presentada és homogènia i comparable.
3.3. Reasons for and effects on the annual accounts of changes in accounting criteria and error corrections	3.3. Raons e incidència en els comptes anuals dels canvis en criteris de comptabilització i correcció d'errors
There were no changes to the accounting criteria in the previous financial year nor were any errors identified that had to be corrected.	No s'han produït canvis en els criteris comptables respecte a l'exercici anterior ni s'han identificat errors que haurien de ser corregits.
3.4. Information on changes in accounting estimates where these are	3.4. Informació sobre canvis en estimacions comptables quan siguin significatius
significant There were no significant changes to the accounting estimates.	No s'han produït canvis significatius en les estimacions comptables.
4. Recognition and valuation regulations	4. Normes de reconeixement i valoració
The most important accounting criteria applied in the preparation of the annual accounts were as follows:	Els criteris comptables més significatius aplicats en la formulació dels comptes anuals són els que es descriuen a continuació:
4.1. Tangible fixed assets	4.1. Immobilitzat material
Capitalisation Criteria	Criteris d'activació
These are tangible assets, movable and immovable property which:	Són actius tangibles, mobles i immobles que:
• The City Council possesses for its own use in the production or supply of goods and services or for its own administrative purposes.	• Posseeix l'Ajuntament per al seu ús en la producció o subministrament de béns i serveis o per als seus propis propòsits administratius.
• These are expected to have a useful life of over a year.	• S'espera que tinguin una vida útil major a un any.
Initial valuation	Valoració inicial
Investments in tangible fixed assets are valued at cost. This is the “acquisition price”, which includes the non-recoverable indirect taxes associated with the purchase, the acquisition costs directly relating to the purchase and, where necessary, the costs for putting the acquisition into service.	Les inversions en béns de l'immobilitzat material es valoren al seu cost. Això és el “preu d'adquisició”, inclosos els impostos indirectes no recuperables associats a la compra, els costos d'adquisició directament relacionats amb la compra i els de posada en funcionament, si escau.
Assets that appear as a result of a physical inventory taking are entered under their fair value where it was not possible to obtain evidence of their original cost.	Els béns aflorats com a conseqüència de la realització d'un inventari físic són registrats pel seu valor raonable si no ha estat possible obtenir evidència del seu cost original.
Received assets allocated for a period equal to or in excess of their economic life	Els béns rebuts en cessió per un termini igual o superior a la vida econòmica del bé es registren pel seu valor net comptable a la data de formalització la cessió.
are entered under their net accounting value on their formal allocation. Additions from before 1 January 1992 are valued according to an expert estimate of their real market value carried out by an independent valuation company. For historical and artistic properties, the valuation includes their replacement value.	Les addicions anteriors a l'1 de gener de 1992 es troben valorades segons una estimació pericial del valor real de mercat en ús realitzada per una societat de taxació independent. En el cas d'immobles de caràcter historicoartístic, la taxació recull el seu valor de reposició.
Capitalisation of financial expenditure	Capitalització de despeses financeres
Financial expenditure is not incorporated in the tangible fixed assets' costs.	No s'incorporen despeses financeres en el cost dels béns de l'immobilitzat material.
Subsequent valuation	Valoració posterior
Tangible fixed asset elements are generally valued at cost, plus subsequent payments, less accumulated depreciation and valuation adjustments for impairment.	Amb caràcter general, els elements de l'immobilitzat material es valoren al seu cost, més els desemborsaments posteriors, menys l'amortització acumulada i les correccions valoratives per deteriorament.
Assets subject to depreciation are reviewed where some event or change in	Els actius subjectes a amortització se sotmeten a revisió sempre que algun
circumstances may involve their accounting value becoming non-recoverable.	succés o canvi en les circumstàncies pot implicar que el valor comptable no
Valuation adjustments for impairment are made when the asset's recoverable	sigui recuperable. Les correccions valoratives per deteriorament es practiquen
amount is below its net depreciation value, and that generally occurs because	quan l'import recuperable de l'actiu (valor raonable) és inferior al seu valor net
of physical impairment, obsolescence or a reduction in the initially expected performance. Assets that have suffered an impairment loss are regularly reviewed for possible reversals of impairment losses.	d'amortitzacions, i que succeeix, generalment, per: deteriorament físic sobrevingut, obsolescència accelerada o disminució del rendiment esperat inicialment. Els actius que han sofert una pèrdua per deteriorament se sotmeten a revisions regulars per si s'haguessin produït reversions de la pèrdua.
Extension, modernisation or improvement costs are capitalised as an increase in	Els costos d'ampliació, modernització o millora s'incorporen a l'actiu com a major
asset value where they increase its capacity or productivity or extend its useful life.	valor del bé quan suposen un augment de la seva capacitat, productivitat o
Costs for major repairs, inspections or major restorations are capitalised and	
depreciated over their useful lives.	allargament de la seva vida útil.
The City Council does not usually use its own staff to carry out work that is subject to capitalisation.	Els costos de grans reparacions, inspeccions o restauracions importants s'activen i s'amortitzen durant la vida útil d'aquestes.
Where the ownership or use of a property requires the site's dismantling and	L'Ajuntament no sol portar a terme treballs amb personal propi que siguin
restoration, these costs are capitalised and depreciated over the period that the property's financial returns or service potential is expected to be obtained.	susceptibles d'activació. En cas que la propietat o ús d'un terreny exigeixi el desmantellament i rehabilitació de l'emplaçament, aquests costos s'activen i s'amortitzen en el període que es prevegi obtenir rendiments econòmics o potencial de servei del terreny.
Indications of impairment were evaluated at the close of the financial year for elements of fixed assets bringing in future financial revenue, taking the following circumstances into account:	Al tancament de l'exercici s'han avaluat els indicis de deteriorament dels elements dels immobilitzats portadors de rendiments econòmics futurs tenint en compte les següents circumstàncies:
• There were no significant changes to the technological or legal environment during the financial year or which were expected to occur in the short term and which would have a negative impact on the City Council.	• No hi ha hagut canvis significatius de l'entorn tecnològic o legal durant l'exercici o que s'esperi que es produeixin a curt termini i que tinguin una incidència negativa a l'Ajuntament.
• There were no significant reductions in the market value of assets.	• No s'ha produït disminucions significatives del valor de mercat dels actius.
• There are no obsolete assets or assets that are physically impaired in any	• No existeixen actius obsolets o deteriorats físicament que siguin significatius.
significant way.	• No hi ha hagut canvis significatius respecte a la forma d'utilització dels actius
• There were no significant changes to the way in which the assets were used during the financial year that had a negative impact on the City Council.	durant l'exercici que tinguin una incidència negativa a l'Ajuntament.
• There was no evidence to support the view that the assets' financial performance was significantly below that which was expected.	• No hi ha evidències que fonamentin que el rendiment econòmic dels actius sigui significativament inferior a allò esperat.
Depreciation	Amortització
The elements that make up the tangible fixed assets, with the exception of	Els elements que integren l'immobilitzat material, amb excepció dels terrenys,
the land, are subject to systematic depreciation using the straight-line method	són objecte d'amortització sistemàtica pel mètode lineal en funció de la vida
according to the estimated useful life of each. By default, each element's	útil estimada de cadascun d'ells. Per defecte, la base amortitzable de cada
depreciable basis matches its book value, given that the residual values are	element coincideix amb el seu valor comptable, donat que es consideren nuls els
deemed to be null. The depreciation process starts when the asset is put into	valors residuals. El procés d'amortització s'inicia en el moment de la posada en
operation, with the estimated useful years of life being as follows:	funcionament del bé, essent els anys de vida útil estimats els següents:
The economic depreciation process began in the 1992 financial year. The estimated years of useful life corresponding to “Buildings” were set out under the criteria established by the above-mentioned independent valuation.	El procés d'amortització econòmica es va iniciar en l'exercici 1992. Els anys de vida útil estimada corresponents a l'epígraf “Construccions” s'ha fixat d'acord amb els criteris establerts per la taxació independent esmentada anteriorment.
With regard to historical and artistic properties, depreciation was calculated on	En el cas dels béns immobles de caràcter historicoartístic, l'amortització es
the basis of the cost of a replacement of the fixed asset that would reproduce its	practica sobre el cost de reposició de l'immobilitzat que reproduiria la seva
capacity and utility. Its depreciation base therefore excluded the book value part	capacitat i utilitat, i s'exclou, per tant, de la base d'amortització la part del valor
that corresponded to the historical and artistic component of the building, which rose to €221,573,000 during the 2017 financial year, all on the basis of the above- mentioned independent valuation. This treatment was justified by the fact that the above-mentioned historical and artistic component was subject to maintenance to ensure the long-term duration of its value.	registrat en llibres que correspon al component historicoartístic de la construcció, que, durant l'exercici 2017, ha ascendit a 221.573 milers d'euros, tot això sobre la base de la taxació independent indicada anteriorment. Aquest tractament es justifica pel fet que el component historicoartístic esmentat és objecte del manteniment que garanteix la permanència del seu valor.
4.2. Public Land Assets	4.2. Patrimoni Públic del Sòl
Public Land Assets (PLA) refers to the group of assets that were allocated, under Legislative Decree 1/2005 of 26 July, approving the consolidated text of the Act on Urban Planning in Catalonia, and under the Barcelona Municipal Charter, for social-interest purposes established by law.	El Patrimoni Públic del Sòl (PMS) fa referència al conjunt de béns que, d'acord amb el Decret Legislatiu 1/2005, de 26 de juliol, pel qual s'aprova el text refós de la llei d'urbanisme de Catalunya, i d'acord amb la Carta Municipal de Barcelona, estan afectats a les finalitats d'interès social que estableix la llei.
The municipally owned properties which fall under this item are as follows:	Les finques de titularitat municipal que es recullen sota aquest epígraf són les
• Properties allocated for social housing, managed by the City Council itself or by municipal operators.	següents: • Finques destinades a habitatge social, gestionades pel propi Ajuntament o per operadors municipals.
• Properties over which surface rights were awarded in favour of third parties, to build social housing, residences for elderly people, care centres and other social investments.	• Finques sobre les quals s'han atorgat drets de superfície a favor de tercers, per a construir habitatge social, residències per a gent gran, centres d'assistència i d'altres inversions de caràcter social.
• Properties on which investment projects were being carried out, which, once completed, would enable their allocation to social housing and other social-interest initiatives.	• Finques sobre les quals s'estan executant projectes d'inversió, que un cop finalitzats permetran la seva destinació a habitatge social i a d'altres actuacions d'interès social.
As regards the 100 x 1000 Plan, the budget commitments implemented by this	Respecte el Pla 100 x 1000, les obligacions pressupostàries que implementen
plan are treated as capital transfers, effecting the way they are recorded in the	aquest pla es comptabilitzen com a transferències de capital i impactant el seu
profit and loss statement.	registre en el compte de resultats.
Transactions associated with this plan therefore have a neutral effect on the profit and loss statement, the receipt of assets linked to the plan and their entry in the municipal inventory is recorded as a gain from public ownership of the land.	Per tal que les operacions associades a aquest pla siguin neutres respecte el compte de resultats, la recepció dels béns vinculats al pla i la seva alta a l'inventari municipal es registra com a benefici procedent del patronat públic del sòl.
The valuation and depreciation criteria for the various types of assets are	Els criteris de valoració i amortització per als diferents tipus de béns són els
described in Note 4.1.	descrits a la nota 4.1.
4.3. Property investments	4.3. Inversions immobiliàries
	Es tracta d'immobles (terrenys o edificis) que es tenen per a obtenir rendes,
	plusvàlues o ambdues, a través del seu arrendament o alienació, sense que sigui
These are properties (land or buildings) that are held for profit or capital gain or	cap d'aquestes una finalitat de l'Ajuntament. I en tot cas, tots aquells que no es
both, through their rents or alienation, without any of these being a purpose of the City Council. And, in any event, all those that may not be considered fixed assets. The tangible fixed asset valuation criteria described in Note 4.1 apply to these investments.	puguin considerar immobilitzat. A aquestes inversions se'ls apliquen els criteris de valoració de l'immobilitzat material descrits a la nota 4.1.
4.4. Intangible fixed assets	4.4. Immobilitzat intangible
Capitalisation Criteria	Criteris d'activació
These are intangible assets and rights that can be financially valued as non-	Es tracta de béns intangibles i drets susceptibles de valoració econòmica de
	caràcter no monetari i sense aparença física que complint les característiques
monetary assets without physical substance which are identifiable by satisfying	de permanència en el temps i utilització en la producció de béns i serveis, o
the characteristics of continuity over time and use in the production of goods and services or constituting a source of the City Council's resources. In other words:	constituint una font de recursos de l'Ajuntament, són identificables. És a dir:
• They are separable and capable of disposal, assignment, renting, exchange and delivery for their exploitation.	• Són separables i susceptibles de ser alienats, cedits, arrendats, intercanviats o lliurats per a la seva explotació.
• They arise from contractual and other legal rights, regardless of whether such rights are assignable or separable from other rights and obligations.	• Sorgeixen de drets contractuals o d'altres drets legals, amb independència que aquests drets siguin transferibles o separables d'altres drets o obligacions.
Initial valuation	Valoració inicial
Investments in intangible fixed assets are valued at cost. This is the “acquisition	Les inversions en béns de l'immobilitzat intangible es valoren al seu cost. Això és
price”, which includes the non-recoverable indirect taxes associated with the	el “preu d'adquisició”, inclosos els impostos indirectes no recuperables associats
purchase, the acquisition costs directly relating to the purchase and, where	a la compra, els costos d'adquisició directament relacionats amb la compra i els
necessary, putting the acquisition into service, or the “production costs” resulting	de posada en funcionament, si escau, o el “cost de producció” en aquells que han
from actual work.	estat resultat de treballs propis.
Subsequent valuation	Valoració posterior
They are generally valued at cost, plus subsequent payments, less accumulated	Amb caràcter general, es valoren al seu cost, més els desemborsaments posteriors, menys l'amortització acumulada i les correccions valoratives per deteriorament.
depreciation and valuation adjustments for impairment.	Les correccions valoratives per deteriorament es practiquen quan l'import
Valuation adjustments for impairment are made when the asset's recoverable	recuperable de l'actiu és inferior al seu valor net d'amortitzacions, i que succeeix,
amount is below its net depreciation value and that generally occurs because of	generalment, per obsolescència accelerada, o disminució del rendiment esperat
rapid obsolescence or reduction in the initially expected performance.	inicialment. Els costos d'ampliació, modernització o millora s'incorporen a l'actiu com a major
Extension, modernisation or improvement costs are capitalised as an increase in	valor del bé quan suposen un augment de la seva capacitat, productivitat o
asset value where they increase its capacity or productivity or extend its useful life.	allargament de la seva vida útil.
Depreciation	Amortització
The elements that make up intangible fixed assets will be subject to systematic	Els elements que integren l'immobilitzat intangible seran objecte d'amortització
depreciation using the straight-line method according to the estimated useful life	sistemàtica pel mètode lineal en funció de la vida útil estimada de cadascun
	d'ells. Per defecte, la base amortitzable de cada element coincideix amb el seu
of each. By default, each element's depreciable basis matches its book value, given that the residual values are deemed to be null. The depreciation process starts when the asset is put into service, with the estimated useful years of life being as follows:	valor comptable, donat que es consideren nuls els valors residuals. El procés d'amortització s'inicia en el moment de la seva posada en servei, essent els anys de vida útil estimats els següents:
4.5. Leases	4.5. Arrendaments
The City Council does not have any assets at its disposal acquired through financial leasing.	L'Ajuntament no disposa de béns adquirits mitjançant arrendament financer.
4.6. Asset exchanges	4.6. Permutes
The City Council does not usually carry out asset exchange transactions during the normal course of its activities. Where these do take place, their book value and inclusion in the accounts must meet the provisions set down in Section 4(d) of the IMNCL's rules for recording and valuing tangible fixed assets.	L'Ajuntament no sol realitzar operacions de permuta en el curs normal de les seves activitats. En tot cas, quan aquestes es produeixen, la seva valoració i registre comptable s'ajusta a l'establert a l'apartat 4.d) de la norma de reconeixement i valoració de l'immobilitzat material de la IMNCL.
4.7. Financial assets and liabilities	4.7. Actius i passius financers
Financial assets and liabilities come from financial instruments, which are contracts that establish a right for one of the parties (financial asset) and an obligation (financial liability) or a component of net equity (equity instrument) for the other party.	Els actius i passius financers deriven dels instruments financers, que són contractes que estableixen un dret per una de les parts (actiu financer) i una obligació (passiu financer) o un component del patrimoni net (instrument de patrimoni) per l'altra.
They are basically classified, valued and entered into the accounts according to the purpose for which they are maintained or for which they were issued.	La seva classificació, valoració i comptabilització es realitza, bàsicament, segons la finalitat per la qual es mantenen o s'han emès.
4.7.1. Financial assets	4.7.1. Actius financers
Financial assets consist of money in cash, capital or net equity instruments of another entity and the rights to receive cash or other financial assets from a third	Són actius financers els diners en efectiu, els instruments de capital o de patrimoni net d'una altra entitat i els drets de rebre efectiu o altre actiu financer d'un tercer o d'intercanviar amb un tercer actius o passius financers en condicions potencialment favorables per l'Ajuntament.
party or to exchange financial assets or liabilities with a third party in conditions	Els actius financers es classifiquen, a efectes de la seva valoració, en:
that are potentially favourable for the City Council.	
Financial assets are classed, for valuation purposes, under:	
a) Credit and receivables	a) Crèdits i partides a cobrar
They include:	Inclouen:
• Credit for transactions arising from usual activities.	• Els crèdits per operacions derivades de l'activitat habitual.
• Other financial assets that generate cash flows of a specified amount and	• Altres actius financers que generen fluxos d'efectiu d'import determinat i
regarding which all expenditure is expected to be recovered, except for reasons attributable to credit impairment.	respecte dels quals s'espera recuperar tot el desemborsament, excepte per motius imputables al deteriorament creditici.
As a general rule, short-term credit and receivables are valued, on both initial and subsequent entering into the accounts, according to their nominal value, except where these incorporate a contractual interest. The same valuation is made with long-term credit and receivables where the effect of updating the flows is not significant. Otherwise, they are valued according to their fair value and subsequently at depreciated cost, by entering into the accounts the accrued interest according to its effective interest rate as the financial year's income.	Com a norma general, els crèdits i partides a cobrar amb venciment a curt termini es valoren, tant en el moment de reconeixement inicial com posteriorment, pel seu valor nominal, excepte que incorporin un interès contractual. La mateixa valoració es realitza amb els de venciment a llarg termini quan l'efecte d'actualitzar els fluxos no és significatiu. En cas contrari, es valoren pel seu valor raonable i posteriorment a cost amortitzat, reconeixent els interessos meritats en funció del seu tipus d'interès efectiu com a ingressos de l'exercici.
Any guarantees and deposits made are always valued according to delivered value.	En tot cas, les fiances i dipòsits constituïts es valoren sempre per l'import lliurat.
b) Financial assets available for sale	b) Actius financers disponibles per a la venda
This includes financial assets that do not meet the requirements for inclusion in any of the previous categories. They are always valued at fair value and any changes that occur in them are entered in the accounts as net equity up to their disposal or impairment.	Inclou els actius financers que no compleixin els requisits per a ser inclosos en alguna de les categories anteriors. Es valoren en tot moment pel seu valor raonable, i els canvis que es produeixen en aquest es registren en el patrimoni net fins a la seva alienació o deteriorament.
c) Investments in the equity of the entities of the group, multi-group and associates	c) Inversions en el patrimoni de les entitats del grup, multigrup i associades
This includes financial assets corresponding to the entities of the group, multi-group and associates under the definition of the standards for drawing up consolidated accounts in the public sector as approved under Order HAP/1489/2013 of 18 July.	Inclou els actius financers corresponents a les entitats del grup, multigrup i associades d'acord amb la definició de les normes per a la formulació de les comptes anuals consolidats en l'àmbit del sector públic aprovades per l'Ordre HAP/1489/2013, de 18 de juliol.
Shareholdings in trading and associated companies were initially valued at cost, corresponding to the fair value of the consideration delivered plus the transaction costs directly attributable to it.	Les participacions en societats mercantils i associades han estat valorades inicialment a cost, que equival al valor raonable de la contraprestació entregada més els costos de transacció que li siguin directament atribuïbles.
Shareholdings in other entities of the group, multi-group and associates were initially valued under Rule 18, section 4, and Rule 19 of the General Accounting Plan for Local Authorities (PGCAL), as well as the notes or particular	Les participacions en la resta d'entitats del grup, multigrup i associades han
aspects issued by the National State Authority (IGAE) on the accounting commencement of the 2015 financial year (Section V.9), and more specifically:	estat valorades inicialment conforme a les normes 18-, apartat 4, i 19- del Pla general de comptabilitat pública adaptat a l'Administració local, així com a les notes o aspectes particulars emeses per la IGAE sobre l'obertura comptable de l'exercici 2015 (apartat V.9è), i en concret:
• The value of the contributions made as assets assigned from local entities to their subsidiary or linked public organisations for a value corresponding to that of the assets at the time of assignment.	• A l'import de les aportacions efectuades en concepte d'adscripció de béns per les entitats locals a ens dependents o vinculats per un valor equivalent al dels béns adscrits en el moment de l'adscripció.
• The value of the contributions made as assets assigned from local entities to subsidiary or linked private organisations for a value corresponding to that of the assets handed over at the time of assignment.	• A l'import de les aportacions efectuades en concepte de cessió de béns per les entitats locals a ens dependents o vinculats per un valor equivalent al dels béns lliurats en cessió en el moment de l'adscripció.
• The value of the initial direct capital contributions as well as subsequent increases for the assumption of new powers from the linked entities.	• A l'import de les aportacions patrimonials inicials directes, així com les posteriors ampliacions per l'assumpció de noves competències dels ens vinculats.
Notwithstanding the investments in the next month of entities in the public administration sector made prior to the entry into force of the IMNCL 2013, are valued according to the value of assets assigned by municipal bodies to those entities as of 31/12/2014 and more specifically:	No obstant les inversions en el patrimoni d'entitats del sector públic administratiu realitzades amb anterioritat a l'entrada en vigor de la IMNCL 2013 estan valorades
• Picasso Museum Foundation: € 64,661,258.83 • PAMEM: € 2,267,581.04	pel valor del patrimoni lliurat en adscripció a aquelles entitats a 31. 12.2014 i en
• Mar Parc Salut Barcelona Consortium: € 117,549,677.81 • Teatre Lliure Foundation: € 2,616,943.05 • Parc d'Atraccions Tibidabo, SA € 22,847,837.14 • Mies Van der Rohe Foundation: € 5,929,585.42	concret: • Fundació Museu Picasso: 64.661.258,83 euros • PAMEM: 2.267.581,04 euros • Consorci Mar Parc Salut Barcelona: 117.549.677,81 euros • Fundació Teatre Lliure: 2.616.943,05 euros • Parc d'Atraccions Tibidabo, SA: 22.847.837,14 euros • Fundació Mies Van der Rohe: 5.929.585,42 euros
The subsequent valuation of the financial assets corresponding to the entities of the group, multi-group and associates was made at initial cost, less, where appropriate, the accumulated amount of the valuation adjustments for	La valoració posterior dels actius financers corresponents a les entitats del grup, multigrup i associades, s'han valorat pel seu cost inicial, menys, en el seu cas,
impairment.	l'import acumulat de les correccions valoratives per deteriorament.
Recognition	Reconeixement
Financial assets are entered in the accounts on the date established in the contract or agreement on which basis the City Council acquires the right. As a general	El reconeixement comptable dels actius financers es realitza a la data establerta en el contracte o acord a partir de la qual l'Ajuntament adquireix el dret. Com a norma general, els costos de les transaccions s'imputen al resultat de l'exercici, excepte
rule, the costs of the transactions are allocated to the financial year's profit (loss), except where their scale makes it advisable to incorporate them into the value of the financial asset. They are classed as fixed or current respectively, depending on whether they mature in over or under one year.	quan la seva magnitud aconsella incorporar-los en el valor de l'actiu financer. Es classifiquen com a no corrent quan el seu venciment és superior a un any i com a corrent quan és inferior.
Impairment	Deteriorament
In the case of credit and other receivables, at least at the close of the financial	En el cas dels crèdits i altres partides a cobrar, almenys al tancament de l'exercici,
year, the appropriate revisions are carried out to detect the need for making	s'efectuen les revisions oportunes per detectar la necessitat de practicar
valuation adjustments for impairment, in the event there is objective evidence that the amounts entered in the accounts will not be received in their entirety and it is advisable to revert them where they are no longer appropriate. Both the value adjustments and the reversals are recognised in the Income and Expenditure	correccions valoratives per deteriorament de valor, en cas d'evidència objectiva que no es cobraran els imports comptabilitzats en la seva integritat, així com la conveniència de revertir-les en aquells casos que ja no siguin procedents. Tant les correccions de valor com les reversions es reconeixen en el compte del resultat
Account.	econòmic patrimonial.
The impairment of tax receivables is calculated by applying ratios on how collectable receivables are, calculated according to real historical series, on the settlement made individually for each of the tax figures and in each specific financial year.	El deteriorament dels deutors tributaris es calcula mitjançant l'aplicació de percentatges d'esperança de cobrament, basats en sèries històriques reals,
As a general rule, neither receivables for subsidies awarded by public bodies nor	sobre la liquidació efectuada a cadascuna de les figures tributàries de forma
	individualitzada, i en cada exercici concret.
receivables guaranteed in the corresponding percentages are subject to impairment.	Com a regla general, no són objecte de deteriorament els crèdits a cobrar per
	subvencions atorgades per organismes públics, així com els garantits en els
	percentatges corresponents.
Where the equity instruments originate from capital fund contributions, the	En el cas dels instruments de patrimoni amb origen amb aportacions de fons
recoverable amount is used to determine the amount of the adjustment value,	patrimonials, per determinar l'import de la correcció valorativa es considera
that being understood as the larger amount between the fair value less the sale	l'import recuperable, entenent aquest com el major import entre el seu valor
expenditure and the current value of the cash flows derived from the investment.	raonable menys les despeses de venda i el valor actual dels fluxos d'efectiu
For want of better evidence of the recoverable value, account has been taken, in	derivats de la inversió. Excepte millor evidència de l'import recuperable, en
estimating the impairment of these investments, of the net equity of the subsidiary	l'estimació del deteriorament d'aquestes inversions es pren en consideració el
entity corrected for the adjusted changes for the unrealised capital gain on their valuation date.	patrimoni net de l'entitat participada corregit per les plusvàlues tàcites existents en la data de valoració.
Both the above-mentioned valuation adjustments for impairment and their reversal	Les citades correccions valoratives per deteriorament, així com la seva reversió, es
are entered in the accounts as an expense or an income, respectively, in the financial year's results.	reconeixen com una despesa o un ingrés, respectivament, en el resultat de l'exercici. Baixa d'actius financers
Write-offs of financial assets	Es registra la baixa d'un actiu financer o d'una part del mateix quan ha expirat
A financial asset is wholly or partly written off in the accounts where it has expired or the rights over the cash flows it generates and the risks and advantages inherent in its ownership have been substantially assigned.	o s'han transmès els drets sobre els fluxos d'efectiu que genera i els riscos i avantatges inherents a la seva propietat de forma substancial.
4.7.2. Financial liabilities	4.7.2. Passius financers
All financial liabilities are classed under the category of financial liabilities at depreciated cost. They include:	La totalitat dels passius financers es classifiquen en la categoria de passius financers a cost amortitzat. Inclouen:
• Debt and accounts payable for transactions arising from usual activities.	• Dèbits i partides a pagar per operacions derivades de l'activitat habitual.
• Debts with credit institutions.	• Deutes amb entitats de crèdit.
• Debt represented in negotiated securities issued.	• Deutes representats en valors negociables emesos.
• Other debt and accounts payable.	• Altres dèbits i partides a pagar.
As a general rule, short-term debt and accounts payable without contractual interest are valued, on both initial and subsequent entering into the accounts, according to their nominal value. The same valuation is made with long-term debt and accounts payable and long-term loans received with subsidised interest where the overall effect of not updating the flows is not significant. Where it is significant, they are initially valued at the current value of the cash flows payable, at a rate equivalent to that which applies for deferred payments and, subsequently, at depreciated cost, and the accrued interest is entered in the books according to its effective rate as income for the financial year. In any case, guarantees and deposits received are always valued according to received value.	Com a norma general, els dèbits i les partides a pagar amb venciment a curt termini sense interès contractual es valoren, tant en el moment del reconeixement inicial com posteriorment, pel seu valor nominal. La mateixa valoració es realitza amb els de venciment a llarg termini i els préstecs rebuts a llarg termini amb interessos subvencionats quan l'efecte global de no actualitzar els fluxos no és significatiu. En cas que sigui significatiu, es valoren inicialment pel valor actual dels fluxos d'efectiu a pagar, sobre una taxa equivalent a l'aplicable als pagaments ajornats i, posteriorment, a cost amortitzat, reconeixent els interessos meritats en funció del seu tipus d'interès efectiu com a ingressos de l'exercici. En tot cas, les fiances i els dipòsits rebuts es valoren sempre per l'import rebut.
Recognition	Reconeixement
The financial liabilities are entered in the accounts on the date established in the contract or agreement on which basis the City Council incurs the obligation. In liquid asset transactions entered into with credit policies, debentures are incurred with the receipt of the successive liquid fund assets. They are classed as fixed or current respectively, depending on whether they mature in over or under one year.	El reconeixement comptable dels passius financers es realitza a la data establerta en el contracte o acord a partir de la qual l'Ajuntament contrau l'obligació. En les operacions de tresoreria formalitzades amb pòlissa de crèdit, les obligacions es contrauen amb la recepció de les successives disponibilitats de fons. Es classifiquen com a no corrent quan el seu venciment és superior a un any i com a corrent quan és inferior.
Financial liability write-offs	Baixa de passius financers
As a general rule, a financial liability is wholly or partly written off when the obligation incurred has been satisfied or cancelled. Where there is a difference between the accounting value and the consideration delivered, this is recorded in the Income and Expenditure Account for the financial year in which it takes place.	Com a norma general, es registra la baixa d'un passiu financer o d'una part del mateix quan l'obligació contreta s'ha complert o cancel·lat. En cas de produir-se una diferència entre el valor comptable i la contraprestació lliurada, es reconeixerà en el resultat de l'exercici que tingui lloc.
4.7.3. Financial guarantee contracts	4.7.3. Contractes de garanties financeres
These are contracts that put the City Council under an obligation to make or receive specific payments to reimburse a third party for any loss incurred where a (“guaranteed”) debtor fails to meet its payment obligations generally arising from debt instruments such as a loan guarantee.	Són contractes que obliguen l'Ajuntament a fer o rebre uns pagaments específics pel reemborsament a un tercer per la pèrdua incorreguda quan un deutor (“garantit”) incompleix la seva obligació de pagament derivada, generalment, d'instruments de deute, tal com un aval.
The City Council had not entered into any financial guarantee contracts.	L'Ajuntament no té formalitzats contractes de garanties financeres.
4.8. Accounting hedges	4.8. Cobertures comptables
These are valued under the same criteria as hedged items, i.e. at depreciated cost. Currently, the City Council has exclusively covered interest hedging transactions.	Es valoren amb el mateix criteri que la partida coberta, és a dir, a cost amortitzat. En l'actualitat l'Ajuntament té subscrites operacions de cobertura de tipus d'interès, exclusivament.
4.9. Inventories	4.9. Existències
The City Council has no assets regarded as inventories.	L'Ajuntament no té actius considerats existències.
4.10. Assets constructed or acquired for other entities	4.10. Actius construïts o adquirits per a altres entitats
The City Council has no assets constructed or acquired for other entities.	L'Ajuntament no té actius construïts o adquirits per a altres entitats.
4.11. Transactions in foreign currency	4.11. Transaccions en moneda estrangera
Transactions in a currency other than the euro are entered in the accounts as soon as they are recognised in euros, by applying the rate of exchange in the existing cash to the corresponding amount on the date of the transaction.	Les transaccions en moneda distinta de l'euro es registren en el moment del seu reconeixement en euros, aplicant a l'import corresponent el tipus de canvi al comptat existent en la data de l'operació.
4.12. Income and expenditure	4.12. Ingressos i despeses
Income and expenditure are entered in the accounts according to the accrual	Els ingressos i les despeses es registren pel principi de meritació i, en els casos que sigui pertinent, pel de correlació entre ambdós.
principle and, where appropriate, the correlation principle between both.	Pressupostàriament, els ingressos i despeses s'incorporen a la liquidació
As regards the budget, income and expenditure are incorporated into the budget settlement when the administrative procedure is produced, acknowledging the respective rights and debentures.	pressupostària en el moment en què es produeix l'acte administratiu de reconeixement dels respectius drets i obligacions.
4.12.1. Income	4.12.1. Ingressos
a) Income and consideration	a) Ingressos amb contraprestacions
As a general rule, income is entered in the accounts according to the fair value	Com a norma general, els ingressos es registren pel valor raonable de la
of the consideration and represents the receivables for goods delivered and	contraprestació i representen els imports a cobrar pels béns lliurats i els serveis
services provided during the ordinary course of the City Council's activities, less	prestats en el curs ordinari de les activitats de l'Ajuntament, deduïdes les
repayments, write-offs, discounts and VAT, where appropriate.	devolucions, les rebaixes, els descomptes i l'Impost sobre el Valor Afegit, si escau.
The City Council recognises income when its amount can be reliably valued: it is	L'Ajuntament reconeix els ingressos quan l'import d'aquests es pot valorar
probable that the City Council will receive the future financial gain and that the	amb fiabilitat; és probable que els beneficis econòmics futurs vagin a fluir a
specific conditions for each of the activities, as detailed below, will be met.	l'Ajuntament i es compleixen les condicions específiques per a cadascuna de les
	activitats tal com es detalla a continuació.
Income from sales is registered when: the City Council has transferred to the	Els ingressos per vendes són registrats quan: l'Ajuntament ha transferit al
purchaser the risks and benefits derived from the ownership of the goods,	comprador els riscos i els avantatges derivats de la propietat dels béns, amb
irrespective of ownership; it does not reserve for itself any involvement in the	independència de la propietat; no conserva per a si cap implicació en la gestió
current management of the goods sold, nor does it retain effective control over	corrent dels béns venuts, ni reté el control efectiu sobre ells; i les despeses
	associades amb la transacció poden ser mesurades amb fiabilitat.
them; and the expenditure associated with the transaction can be reliably measured.	Els ingressos per a la prestació de serveis es reconeixen quan el resultat de la
Income for the provision of services is recorded when the results of the transaction can be reliably estimated, by considering the degree of progress or performance of the provision on the date of the annual accounts or under the straight-line	transacció pot ser estimat amb fiabilitat, considerant el grau d'avanç o realització de la prestació a la data dels comptes anuals, o de forma lineal quan el servei es
method where the service is provided during a specific period.	presta durant un període determinat.
Where the results cannot be reliably estimated, the income is entered in the	Quan no pot ser estimat de forma fiable, els ingressos són reconeguts en la
accounts according to the total expenditure recognised that is deemed recoverable.	quantia de les despeses reconegudes que es consideren recuperables.
b) Income without consideration	b) Ingressos sense contraprestacions
In the case of taxes, income is entered in the accounts, as is the asset, when the	En el cas dels impostos es reconeixerà l'ingrés i l'actiu quan tingui lloc el fet
taxable transaction takes place and the asset's recognition criteria are satisfied.	imposable i es satisfacin els criteris de reconeixement de l'actiu.
As for fines and penalties, these are entered in the accounts when the right to receive them arises.	En el cas de les multes i sancions es reconeixen quan sorgeix el dret a cobrar-les.
In the case of fines, the right to collect is recognised as soon as the enforcement	Per a les multes el dret de cobrament es reconeix en el moment que s'estableix
of the act is established.	l'executivitat de l'acte d'imposició.
4.12.2. Expenditure	4.12.2. Despeses
Staff and other ordinary management expenses are entered in the Income and Expenditure Account when the obligation falls due, irrespective of when the current monetary expense that comes from it is incurred.	Les despeses de personal i altres despeses de gestió ordinària es reconeixen en el compte del resultat en el moment que merita l'obligació, amb independència del moment en què es produeixi el corrent monetari que se'n deriva.
4.13. Provisions and contingencies	4.13. Provisions i contingències
A provision is entered in the accounts where the City Council has a present (legal, contractual or implied) obligation resulting from a past event which will probably involve the delivery of resources that can be reliably estimated.	Es reconeix una provisió quan l'Ajuntament té una obligació present (legal, contractual o implícita) resultat d'un succés passat que, probablement, implicarà el lliurament d'uns recursos que es poden estimar de forma fiable.
Provisions are valued according to the current value of the payments expected to be necessary for settling the obligation, updated to a rate of discount equivalent to the type of public debt for an analogous maturity. Adjustments to provisions for the purposes of their updating are entered in the accounts as a financial expense as they are reported. Where the maturity is under or equal to one year and the financial effect is not significant they are not discounted.	Les provisions es troben valorades pel valor actual dels desemborsaments que s'espera que seran necessaris per liquidar l'obligació, actualitzats a una taxa de descompte equivalent al tipus de deute públic per un venciment anàleg. Els ajustaments en la provisió amb motiu de la seva actualització es reconeixen com una despesa financera a mesura que es van reportant. Quan el seu venciment és inferior o igual a un any i l'efecte financer no és significatiu, no es descompten.
Provisions or contingencies arising from claims, procedures, lawsuits or litigation, or that have had a ruling or been settled in the tax year, are not recorded if their estimated amount is fully covered by current insurance policies or similar instruments,	Les provisions o contingències provinents de reclamacions, procediments, judicis o litigis en procés, o que hagin tingut sentència o hagin estat resolts en l'exercici, no es registren si el seu import estimat en contra es troba íntegrament cobert mitjançant pòlisses vigents o similars.
Provisions are subject to review and adjusted, where necessary, at the close of the financial year, to reflect the best existing estimate at the time. Where they are no longer relevant or probable, they are then reverted under a balancing entry in the financial year's corresponding income account.	Al tancament de l'exercici, les provisions són objecte de revisió i ajustades, si escau, per a reflectir la millor estimació existent en aquest moment. Quan no són ja pertinents o probables, es procedeix a la seva reversió amb contrapartida al corresponent compte d'ingrés de l'exercici.
For the purposes of quantifying the provisions, reference is made to internal and external expert reports and to the City Council's experience in similar matters, which enable a basis to be established for the estimates of each of the possible outcomes, as well as their financial effects.	Per a la quantificació de les provisions, es recorre a informes interns i, si escau, d'experts externs, i a l'experiència de l'Ajuntament en successos similars, que permetin establir la base de les estimacions de cadascun dels desenllaços possibles, així com del seu efecte financer.
As regards consortia, the existing risk is recorded, according to the City Council's share, in the organisations that have a negative net equity.	En el cas dels consorcis es recull el risc existent, en funció de la participació de l'Ajuntament, en aquells ens que tenen un patrimoni net negatiu.
4.14. Transfers and subsidies	4.14. Transferències i subvencions
4.14.1. Transfers and subsidies received	4.14.1. Transferències i subvencions rebudes
Refundable subsidies are entered in the accounts as liabilities until they meet the conditions for consideration as non-refundable, whereas non-refundable subsidies are recorded as income allocated to net equity and are entered in the accounts as income on a systematic and rational basis that correlates to subsidy-derived expenditure.	Les subvencions que tinguin caràcter reintegrable es registren com a passius fins que compleixin les condicions per a considerar-se no reintegrables, mentre que les subvencions no reintegrables es registren coma ingressos directament imputats al patrimoni net i es reconeixen com a ingressos sobre una base sistemàtica i racional de forma correlacionada amb les despeses derivades de la subvenció.
For these purposes, a subsidy is deemed non-refundable where there is a customised agreement for granting it and where all the conditions established for granting it have been met and there are no reasonable doubts that it will be received.	A aquests efectes, una subvenció es considera no reintegrable quan existeix un acord individualitzat de concessió de la subvenció i s'han complert totes les condicions establertes per a la seva concessió i no existeixen dubtes raonables de que es cobrarà.
Monetary subsidiaries are valued according to the fair value of the referred amount granted when entered in the accounts.	Les subvencions de caràcter monetari es valoren pel valor raonable de l'import concedit referit al moment del seu reconeixement.
Non-refundable grants relating to the purchase of tangible fixed assets are	Les subvencions no reintegrables relacionades amb l'adquisició de l'immobilitzat material s'imputen com a ingressos de l'exercici en proporció a l'amortització dels corresponents actius o, en el seu cas, quan es produeixi la venda, correcció valorativa per deteriorament o baixa en el balanç.
allocated as income for the financial year in proportion to the depreciation of the corresponding assets or, where appropriate, where there is a sale, valuation	D'altra banda, les subvencions no reintegrables relacionades amb despeses específiques es reconeixen en el compte del resultat econòmic patrimonial en el mateix exercici en què es meriten les corresponents despeses.
adjustment for impairment or a shortfall in the balance sheet.	Al tancament de l'exercici es considera que no existeixen dubtes raonables envers el compliment de les condicions i requisits associats a les subvencions rebudes, pel que han estat considerades com a no reintegrables i, per tant, han estat
On the other hand, non-refundable subsidies relating to specific expenditure are	registrades directament com a ingressos en el patrimoni net.
entered in the Income and Expenditure Account in the same financial year that the payment for the corresponding expenditure falls due.	
At the close of the financial year, there are considered to be no reasonable doubts regarding compliance with the conditions and requirements associated with the subsidies received. They are thus considered to be non-returnable and directly recorded as income in net equity.	
4.14.2. Transfers and subsidies granted	4.14.2. Transferències i subvencions atorgades
Authorised transfers and subsidies are entered in the accounts as expenditure as	Les transferències i subvencions atorgades es comptabilitzen com a despeses en el moment que es tingui constància que s'han complert les condicions establertes per a la seva percepció. En cas que al tancament de l'exercici estigui pendent el
soon as it is recorded that the conditions established for their receipt have been	compliment d'alguna de les condicions establertes per a la seva percepció, però
met. Where one of the conditions established for their receipt is yet to be met at the close of the financial year, but there is no reasonable doubt as to future	no existeixin dubtes raonables sobre el seu futur compliment, es dota una provisió pels corresponents imports, amb la finalitat de reflectir la despesa.
compliance, a provision for the corresponding amounts is given, for the purposes	
of reflecting expenditure.	
4.15. Joint activity	4.15. Activitats conjuntes
The City Council has not carried out any joint activity during the financial year.	L'Ajuntament no ha realitzat cap activitat conjunta en l'exercici.
4.16. Assets under sale	4.16. Actius en estat de venda
The City Council has no assets under sale.	L'Ajuntament no té actius en estat de venda.
5. Tangible fixed assets	5. Immobilitzat material
5.1. Movements during the financial year.	5.1. Moviment de l'exercici
5.2. Financial year information	5.2. Informació de l'exercici
The most important investments in the financial year correspond to:	Les inversions més rellevants de l'exercici corresponen a:
At the close of the financial year, the acquisition cost of the goods that were fully depreciated and which remained in use amounted to €317,017,233.10.	Al tancament de l'exercici, el cost d'adquisició de béns que es troben totalment amortitzats i que segueixen en ús ascendeix a 317.017.233,10 euros.
The period of useful life for immovable property starts from the month following the one in which the asset's operational status is registered in the system; as for movable property and infrastructure, it starts the following year.	El període de vida útil dels béns immobles comença a partir del mes següent a aquell en què s'ha registrat en el sistema la posada en funcionament de l'actiu; en el cas dels béns mobles i de les infraestructures és a partir de l'any següent.
Extension, modernisation and improvement costs are added to the accounting value at their conclusion. These costs are depreciated for the remaining years of depreciation of the main element.	Respecte als costos d'ampliació, modernització o millora s'afegeixen a l'import del valor comptable de l'element a la finalització de l'actuació. L'amortització d'aquests costos es porta a terme per els anys restants d'amortització de l'element principal.
The financial year 2017 saw no large-scale repairs or general inspections and no decommissioning of any asset or site restoration; no costs were capitalised for work carried out by the City Council for its immovable property.	En l'exercici 2017 no s'han realitzat grans reparacions o inspeccions generals, ni desmantellament de l'actiu, ni restauració del seu emplaçament, ni s'han activat costos per treballs realitzats per l'Ajuntament per al seu immobilitzat.
5.3. Circumstances that affect tangible fixed asset ownership	5.3. Circumstàncies que afecten a la titularitat de l'immobilitzat material
There is no restriction on the ownership of the goods that make up the City Council's tangible fixed assets and none of these assets is subject to litigation or has been pledged as a guarantee for debt payments.	No existeix cap tipus de restricció sobre la titularitat dels béns que integren l'immobilitzat material de l'Ajuntament ni cap d'ells es troba sotmès a litigi o ha estat ofert en garantia del pagament de deutes.
5.4. Infrastructures	5.4. Infraestructures
The breakdown of the infrastructure costs item are as follows:	El detall del cost de l'epígraf d'infraestructures és com segueix:
5.5. Other substantive circumstances	5.5. Altres circumstàncies de caràcter substantiu
During the course of the 2017 financial year, the Government Commission agreed to acquire eight estates for a total of €48,040,206.55.	Al llarg de l'exercici 2017 la Comissió de Govern va acordar l'adquisició de vuit finques per un import total de 48.040.206,55 euros.
As a result of circumstances involved in the various transactions, the legal	
conveyances of the above-mentioned estates were not completed by the date of these annual accounts. Notwithstanding that fact, the assets were incorporated into the City Council's equity given that the risks and benefits inherent in ownership thereof had been conveyed and there was no rational uncertainty or possibility of the contract contract's rescission.	A conseqüència de circumstàncies concurrents en les diferents operacions, a data d'aquests comptes anuals no han estat perfeccionades les transmissions jurídiques de les finques relacionades. No obstant això, els béns han estat incorporats al patrimoni de l'Ajuntament ja que s'han transmès els riscos i els avantatges inherents a la propietat dels actius no existint, per tant, en termes racionals d'incertesa, la possibilitat de rescissió contractual.
6. Public land assets	6. Patrimoni públic del sòl
6.1. Financial year variations	6.1. Moviment de l'exercici
6.2. Financial year information	6.2. Informació de l'exercici
The most important investments in the financial year correspond to:	Les inversions més rellevants de l'exercici corresponen a:
The period of useful life starts from the month following the one in which the	El període de vida útil comença a partir del mes següent a aquell en què s'ha
asset's operational status is registered with the system.	registrat en el sistema la posada en funcionament de l'actiu.
Extension, modernisation and improvement costs are added to the accounting value at their conclusion. These costs are depreciated for the remaining years of depreciation of the main element.	Respecte als costos d'ampliació, modernització o millora s'afegeixen a l'import del valor comptable de l'element a la finalització de l'actuació. L'amortització d'aquests costos es porta a terme per els anys restants d'amortització de l'element principal.
The financial year 2017 saw no large-scale repairs or general inspections and no decommissioning of any asset or site restoration; no costs were capitalised for work carried out by the City Council for its immovable property.	En l'exercici 2017 no s'han realitzat grans reparacions o inspeccions generals, ni desmantellament de l'actiu, ni restauració del seu emplaçament, ni s'han activat costos per treballs realitzats per l'Ajuntament per al seu immobilitzat.
7. Property investments	7. Inversions immobiliàries
7.1. Financial year variations	7.1. Moviment de l'exercici
7.2. Financial year information	7.2. Informació de l'exercici
The period of useful life starts from the month following the one in which the asset's operational status is registered with the system.	El període de vida útil comença a partir del mes següent a aquell en què s'ha registrat en el sistema la posada en funcionament de l'actiu.
Extension, modernisation and improvement costs are added to the accounting value at their conclusion. These costs are depreciated for the remaining years of depreciation of the main element.	Respecte als costos d'ampliació, modernització o millora s'afegeixen a l'import del valor comptable de l'element a la finalització de l'actuació. L'amortització d'aquests costos es porta a terme per els anys restants d'amortització de l'element principal.
The financial year 2017 saw no large-scale repairs or general inspections and no decommissioning of	En l'exercici 2017 no s'han realitzat grans reparacions o inspeccions generals, ni desmantellament
any asset or site restoration; no costs were capitalised for work carried out by the City Council for its	de l'actiu, ni restauració del seu emplaçament, ni s'han activat costos per treballs realitzats per
immovable property.	l'Ajuntament per al seu immobilitzat.
7.3. Description of property investments	7.3. Descripció de les inversions immobiliàries
This includes buildings that bring in significant rent such as the Convention Centre, the Auditorium of	Recull aquells immobles pels quals s'obtenen rendes significatives com són el Centre de Convencions,
the Forum Building and the Forum Port, as well the building intended for the Ecopark - land site.	l'Auditori de l'edifici Fòrum, el Port del Fòrum, així com l'immoble destinat a Ecopark - solar.
8. Intangible fixed assets	8. Immobilitzat intangible
8.1. Financial year information	8.1. Moviment de l'exercici
8.2. Description of intangible fixed assets	8.2. Descripció de l'immobilitzat intangible
The breakdown of the “other intangible fixed assets” item is as follows:	El detall de l'epígraf de “altre immobilitzat intangible” és com segueix:
8.3. Financial year information	8.3. Informació de l'exercici
At the close of the financial year, the acquisition cost of goods that were totally depreciated and remained in use came to €31,506,942.26.	Al tancament de l'exercici el cost d'adquisició de béns que es troben totalment amortitzats i que segueixen en ús ascendeix a 31.506.942,26 euros.
8.4. Circumstances that affect intangible fixed asset ownership	8.4. Circumstàncies que afecten la titularitat de l'immobilitzat intangible
There is no restriction on the ownership of the goods that make up the City Council's intangible fixed assets and none of these assets is subject to litigation or has been pledged as a guarantee for debt payments.	No existeix cap tipus de restricció sobre la titularitat dels béns que integren l'immobilitzat intangible de l'Ajuntament ni cap d'ells es troba sotmès a litigi o ha estat ofert en garantia del pagament de deutes.
9. Financial leases and other similar transactions	9. Arrendaments financers i altres operacions de naturalesa similar
The City Council does not hold any assets under a financial lease.	L'Ajuntament no disposa de béns en règim d'arrendament financer.
10. Financial assets	10. Actius financers
10.1. Information on the balance sheet	10.1. Informació relacionada amb el balanç
a) Reconciliation statement summary between the balance sheet classification of financial assets and the categories established in the 8th regulation on recognising and valuing financial assets:	a) Estat resum de la conciliació entre la classificació dels actius financers del
Breakdown of long-term investments in entities of the group, multi-group and associates are as follows:	balanç i les categories establertes en la norma de reconeixement i valoració 8 d'actius financers:
Financial assets available for sale refer to the City Council's shareholding in	El detall de les inversions en entitats del grup, multigrup i associades és com segueix:
the companies Nauta Tech Invest III, SCR and Port Forum Sant Adrià, SL for €2,910,928.72 and €12,822.99 respectively and other shareholdings for €599.02.	Els actius financers disponibles per a la venda es refereixen a la participació de l'Ajuntament a les societats Nauta Tech Invest III, SCR i Port Fòrum Sant Adrià, SL per 2.910.928,72 euros i 12.822,99 euros, i altres participacions per 599,02 euros.
b) Reclassifications.	b) Reclassificacions.
The City Council did not reclassify any financial asset over the financial year which required a change in valuation, whether in depreciated cost at fair value or the reverse.	L'Ajuntament no ha reclassificat durant l'exercici cap actiu financer que hagi exigit un canvi de valoració, ja sigui de cost amortitzat a valor raonable, o a la inversa.
c) Financial assets delivered under guarantee.	c) Actius financers lliurats en garantia
The City Council did not deliver or keep any financial asset under guarantee of debt payments during or at the close of the financial year.	Durant l'exercici ni a la data de tancament l'Ajuntament no ha lliurat o manté actius financers en garantia del pagament de deutes.
d) Adjustments for impaired value	d) Correccions pel deteriorament del valor
The value reductions due to deterioration correspond to Fira 2000, SA (€50,887,655.50) and Barcelona Emprén CR, SA, (€336,588.40).	Les disminucions de valor per deteriorament de l'exercici corresponen a Fira 2000, SA, per import de 50.887.655,50 euros i a Barcelona Emprèn CR, SA, per import de 336.588,40 euros.
10.2. Information on the Income and Expenditure Account	10.2. Informació relacionada amb el compte del resultat econòmic-patrimonial.
a) Net results obtained in the financial year from the various categories of financial assets.	a) Resultats nets obtinguts en l'exercici de les diferents categories d'actius financers.
The net results obtained for financial assets classed under the category of credit and accounts payable meant an addition to the Profit and Loss Account of €2,448,645.04.	Els resultats nets obtinguts en relació als actius financers que s'han classificat en la categoria de crèdits i partides a cobrar han suposat un abonament al compte de resultats de 5.474.569,33 euros.
b) Financial income calculated by applying the effective interest rate method.	b) Ingressos financers calculats per l'aplicació del mètode del tipus d'interès efectiu.
The Income and Expenditure Account for the year does not contain financial income calculated this way.	El compte del resultat econòmic-patrimonial de l'exercici no recull ingressos financers calculats d'aquesta manera.
10.3.1. Information on exchange rate and interest rate risks	10.3. Informació sobre els riscos de tipus de canvi i de tipus d'interès
a) Exchange rate risks.	a) Riscos de tipus de canvi.
The City Council has no investments and does not keep significant receivables in any currency other than the euro and therefore has no risks of this kind.	L'Ajuntament no té inversions ni manté saldos a cobrar en moneda diferent de l'euro que siguin significatius i, per tant, no té riscos d'aquest tipus.
b) Interest rate risks.	b) Riscos de tipus d'interès.
The City Council does not keep financial assets valued at depreciated cost, so it has no risks of this nature.	L'Ajuntament no manté actius financers valorats a cost amortitzat, de manera que no té riscos d'aquesta naturalesa.
10.4. Other information	10.4. Altra informació
a) Regular credit operations	a) Crèdits d'operacions habituals.
The long-term balance at the close of the financial year for payment yet to be received in the City Council's usual transactions, “receivables and other accounts receivable”, corresponds to deferred tax payments and instalments.	Al tancament de l'exercici, el saldo a llarg termini pendent de cobrament corresponent a les operacions habituals de l'Ajuntament, “deutors i altres comptes a cobrar”, correspon a deutes per ajornaments o fraccionaments de tributs.
	El saldo a curt termini per les operacions habituals, “deutors i altres comptes a cobrar”, es detalla a continuació:
The short-term balance for usual transactions, “receivables and other accounts receivable” is broken down below:	Els imports i moviments en el compte de deteriorament de valor de crèdits han estat els següents: L'aplicació per anul·lació de drets o cobraments de l'exercici, per import de
Amounts and variations in the Credit Impairment Losses Account were as follows:	40.943.550,78 euros, s'han registrat amb càrrec al compte de resultat econòmic
The application for writing-off the rights or collections of the financial year, amounting to €40,943,550.78, has been charged to the income and expenditure account, while the rest, which amounts to €60,623,106.54, has been charged to net equity, as it corresponds to writing-off closed budgets rights due to the cancellation of the settlements for which it was recognised.	patrimonial mentre que la resta, per un import de 60.623.106,54 euros, s'han registrat amb càrrec al patrimoni net, atès que corresponen a anul·lacions de drets de pressupostos tancats amb motiu de l'anul·lació de les liquidacions per les que foren reconegudes.
b) Cash and other liquid assets.	b) Efectiu i altres actius líquids.
The balance under this item at the close of the financial year has a total of 76 bank accounts presenting the following overall movements:	A la data de tancament de l'exercici el saldo d'aquest epígraf està integrat per un total de 76 comptes bancaris que han presentat el següent moviment global:
The balances as of 31 December include balances that appeared on that date as temporary financial investments.	Als saldos a 31 de desembre s'inclou els saldos que a la data figuraven com a inversions financeres temporals.
c) Investment policy	c) Política d'inversions
As for temporary liquidity surpluses, the conditions for implementing Barcelona City Council's budget establish that they may be capitalised through investments that meet the conditions for liquidity and security provided for under Royal Decree	En relació als excedents temporals de tresoreria, les bases d'execució del pressupost de l'Ajuntament de Barcelona determinen que es podran rendibilitzar
2/2004 TRLRHL.	mitjançant inversions que reuneixin les condicions de liquiditat i seguretat previstes en el Real Decret 2/2004 TRLRHL.
11. Financial liabilities	11. Passius financers
11.1. Position of and movements in debts with credit institutions	11.1. Situació i moviment dels deutes amb entitats de crèdit
a) Breakdown of debt maintained by the City Council at the close of the financial year and valued at depreciation cost	a) Detall dels deutes mantinguts per l'Ajuntament al tancament de l'exercici valorats a cost amortitzat
b) Breakdown of debt maintained by the City Council at fair value at the close of the financial year	b) Detall dels deutes mantinguts per l'Ajuntament al tancament de l'exercici a valor raonable
The City Council does not maintain financial liabilities at fair value on its balance sheet and did not record transactions during the financial year that had to be entered in the accounts at fair value.	L'Ajuntament no manté en balanç passius financers a valor raonable, ni durant l'exercici ha registrat operacions que haguessin de registrar-se a valor raonable.
c) Summary by category	c) Resum per categories
11.2. Credit lines	11.2. Línies de crèdit
During the financial year, the City Council did not take out any credit lines nor were any debts maintained for transactions of this kind on the closing date.	Durant l'exercici, l'Ajuntament no ha contractat cap línia de crèdit ni tampoc a la data de tancament es mantenen deutes per operacions d'aquesta naturalesa.
11.3. Information on exchange rate and interest rate risks	11.3. Informació sobre els riscos de tipus de canvi i de tipus d'interès
a) Exchange rate risks.	a) Riscos de tipus de canvi
The City Council has no debt in currency other than the euro and therefore has no risks of this kind.	L'Ajuntament no té deutes en moneda diferent de l'euro i, per tant, no té riscos d'aquest tipus.
b) Interest rate risks.	b) Riscos de tipus d'interès
The classification of the debt as of 31 December 2017 according to interest rate risk is as follows:	La classificació del deute a 31 de desembre de 2017 segons el risc de tipus d'interès és la següent:
11.4. Endorsements and other guarantees granted	11.4. Avals i altres garanties concedides
a) Endorsements granted	a) Avals concedits
The City Council did not grant any endorsements in favour of third parties during the financial year nor did it maintain any third-party endorsements on the closing date.	Durant l'exercici, l'Ajuntament no ha atorgat avals a favor de tercers, ni a la data de tancament manté avals atorgats a tercers.
b) Endorsements implemented	b) Avals executats
For the reason stated in section (a) above, no endorsements were implemented that the City Council was responsible for.	Per la raó que s'assenyala a l'apartat a) anterior no s'han executat avals dels que hagi de respondre l'Ajuntament.
c) Endorsements repaid	c) Avals reintegrats
By not maintaining any endorsements on behalf of third parties and not having endorsed third-party debts in previous financial years, no endorsements were repaid in favour of the City Council during the financial year.	En no mantenir avals a favor de tercers, ni haver de fer-se càrrec en exercicis anteriors de deutes de tercers, en l'exercici no s'han reintegrat avals a favor de l'Ajuntament.
11.5. Other information on debts with credit institutions	11.5. Altra informació relativa a deutes amb entitats de crèdit
The average cost of debt during the 2017 financial year was 2.11%, and the average life as of 31 December 2017 was 6.8 years.	El cost mitjà del deute durant l'exercici 2017 ha estat del 2,11%, i la vida mitjana a 31 de desembre de 2017 es situa en 6,8 anys.
The debt profile by maturity date as of 31 December 2017 is broken down below:	El perfil del deute per venciments a 31 de desembre de 2017 es detalla a continuació:
The City Council does not have any debts secured with collateral.	L'Ajuntament no manté deutes amb garantia real.
11.6. Other information relating to other debts	11.6. Altra informació relativa a altres deutes
a) Breakdown of debt maintained by the City Council at the close of the financial year and valued at depreciation cost	a) Detall dels deutes mantinguts per l'Ajuntament al tancament de l'exercici valorats a cost amortitzat
The total amount for the final negative settlement of the share in Spanish Central Government taxes corresponding to the 2008 financial year came to €93,487,000, whereas the figure for the 2009 financial year was also negative by €304,284,000. In accordance with the provisions set down in Act 2/2012 of 29 June, on General State Budgets for the year 2012, the term up to December 2014 for offsetting these negative settlements was 120 monthly instalments.	L'import total de la liquidació definitiva negativa de la participació als tributs de l'Estat corresponent a l'exercici 2008 va ascendir a 93.487 milers d'euros, mentre que la corresponent a l'exercici 2009 va ser també negativa per 304.284 milers d'euros. D'acord amb allò previst a la Llei 2/2012, de 29 de juny, de Pressupostos Generals de l'Estat de l'exercici 2012, el termini fins a desembre 2014 de compensació d'aquestes liquidacions negatives era de 120 mensualitats. La disposició addicional única del Reial decret llei 12/2014, de 12 de setembre, establia modificacions en el procediment de reintegrament dels saldos deutors a favor de la Hisenda Pública derivats de les liquidacions definitives de les participacions als tributs de l'Estat dels exercicis 2008 i 2009, regulats a la
The sole additional provision in Royal Decree Act 12/2014 of 12 September, established amendments to the procedure for paying receivables to the Public Treasury arising from final settlements of shares in Spanish Central Government taxes for the financial years 2008 and 2009, as regulated by Act 2/2012 of 29 June, on the State's budgets for the year 2012, and allowed, as at January 2015 and subject to authorisation, extensions to the terms for paying the above-mentioned receivables in 120 additional monthly instalments. The negative settlement for 2008 matures during the 2011-2031 period while the negative settlement for 2009 matures during the 2012-2031 period. The amount maturing in the 2018 financial year is entered in the accounts under the “Other short-term debts” item.	Llei 2/2012, de 29 de juny, de pressupostos de l'estat per a l'any 2012, i ha permès, a partir de gener de 2015 i prèvia autorització, l'ampliació del termini de reintegrament dels esmentats saldos deutors durant 120 mensualitats addicionals. La liquidació negativa del 2008 te venciment durant el període 2011-2031 i la liquidació negativa del 2009 venç durant el període 2012-2031. L'import amb venciment a l'exercici 2018 es troba registrat a l'epígraf d'altres deutes a curt termini.
b) Breakdown of debt maintained by the City Council at fair value at the close of the financial year	b) Detall dels deutes mantinguts per l'Ajuntament al tancament de l'exercici a valor raonable
The City Council does not maintain financial liabilities at fair value on its balance sheet and did not record transactions during the financial year that had to be entered in the accounts at fair value.	L'Ajuntament no manté en balanç passius financers a valor raonable, ni durant l'exercici ha registrat operacions que haguessin de registrar-se a valor raonable.
c) Summary by category	c) Resum per categories
11.7. Other information relating to debt with entities of the group, multigroup and associates	11.7. Altra informació relativa a deutes amb entitats del grup, multigrup i associades
Short-term debts with entities of the group, multi-group and associates are broken down below:	Els deutes amb entitats del grup, multigrup i associades es detallen a continuació:
11.8. Short-term creditors and other accounts payable	11.8. Creditors i altres comptes a pagar a curt termini
The balance under this item is detailed below:	El detall del saldo d'aquest epígraf es detalla a continuació:
11.9. Information on the average payment period to suppliers: Third Additional Provision, “Duty to supply information” of Act 15/2010 of 5 July	11.9. Informació sobre el període mig de pagament a proveïdors: Disposició addicional tercera, “Deure d'informació” de la Llei 15/2010, de 5 de juliol
The following information is provided with regard to the provisions in Act 15/2010 of 5 July, on measures against arrears in commercial transactions, and to the obligations of contracts entered into on 31 December 2017:	En relació al que preveu la Llei 15/2010, de 5 de juliol, de mesures de lluita contra la morositat en operacions comercials, i pel que fa a les obligacions dels contractes formalitzats a data 31 de desembre de 2017 es facilita la següent informació:
The City Council did not default on any of its incurred debts, keeping to the payment deadlines in accordance with the applicable regulations.	L'Ajuntament no ha impagat cap dels deutes contrets, mantenint els terminis de pagament d'acord amb la normativa que li resulta d'aplicació.
12. Accounting hedges	12. Cobertures comptables
Barcelona City Council has a current accounting hedge worth a total of €60,000,000 as of 31 December 2017. This accounting hedge corresponds to a financial interest rate swap under contract to offset variations in the cash flows of the hedged item, given the interest rate risk it is effectively exposed to. The hedged item corresponds to a Schuldschein loan of €60M	L'Ajuntament de Barcelona manté vigent una cobertura comptable per import total de 60.000.000,00 euros a 31 de desembre de 2017. Aquesta cobertura comptable correspon a una permuta financera de tipus d'interès contractada per compensar les variacions en els fluxos d'efectiu de la partida coberta donat el risc de tipus d'interès al que està efectivament exposat. La naturalesa de la partida coberta correspon a un préstec schuldschein de 60M€.
More specifically, the details of the accounting hedge valid as of 31/12/2017 are as follows:	Concretament, el detall de la cobertura comptable vigent a 31/12/2017 és el següent:
	Donat que es compleixen els requisits definits per la IMNCL, l'instrument de
Given that the requirements established by the IMNCL were met, the interest rate hedge instrument that Barcelona City Council kept current as at 31 December 2017 is valued under the same criterion as the hedged item: value at depreciated cost. In that sense, the ledger value of the hedge at the start and close of the 2017 financial years is €60M.	cobertura de tipus d'interès que l'Ajuntament de Barcelona manté vigent a 31 de desembre de 2017 es valora amb el mateix criteri que la partida coberta i que és el de valor a cost amortitzat. En aquest sentit el valor comptable de la cobertura a l'inici i tancament de l'exercici 2017 és de 60M€.
13. Assets constructed or acquired for other entities and other inventories	13. Actius construïts o adquirits per a altres entitats i altres existències
No transactions of this nature took place during the financial year nor were settlements derived from such transactions kept on the balance sheet on the closing date.	No s'han produït operacions d'aquesta naturalesa durant l'exercici, ni a la data de tancament es mantenen en balanç saldos derivats d'aquestes operacions.
14. Foreign currency	14. Moneda estrangera
At the close of the 2017 financial year, the City Council had two current accounts in US dollars, with a balance of $18,000 and €34,000. Their corresponding value on the books as of 31 December 2017 was €15,008.75 and €28,349.87 respectively. The differences in recognised value in the financial year for this concept came to €5,972.55.	A la data de tancament de l'exercici 2017, l'Ajuntament disposa de dos comptes corrents en dòlars, amb un saldo de 18.000 dòlars i 34.000 dòlars. El seu contravalor en llibres a 31 de desembre de 2017 és de 15.008,75 euros i 28.349,87 euros respectivament. Les diferències de valor reconegudes en l'exercici per aquest concepte ascendeixen a 5.972,55 euros.
15. Transfers, subsidies and other income and expenditure	15. Transferències, subvencions i altres ingressos i despeses
15.1. Transfers and subsidies received	15.1. Transferències i subvencions rebudes
15.2. Expenditure	15.2. Despeses
a) Transfers and subsidies granted	a) Transferències i subvencions atorgades
No repayments were made owing to breach of conditions or requirements for using the subsidies.	No s'han produït reintegraments per incompliment de les condicions o requisits per a gaudir de les subvencions.
b) Provisions and services	b) Subministraments i serveis
16. Provisions and contingencies	16. Provisions i contingències
The breakdown of variations during the financial year in the provisions recognised on the liabilities' side of the balance sheet, both short- and long-term, was as follows:	El detall del moviment durant l'exercici de les provisions reconegudes en el passiu del balanç, tant a curt com a llarg termini, ha estat el següent:
The settlement of the provision is aimed at covering the financial costs of contingent or probable obligations.	El saldo de la provisió té per objecte cobrir els costos econòmics d'aquelles obligacions de caràcter contingent o probable.
The value of the provisions recorded is the nominal value it is expected will be required in the future to settle the obligations. They have not been valued at their current value as the financial effect of discounting them is not significant.	El valor de les provisions registrades es correspon amb el valor nominal que s'espera que sigui necessari en el futur per liquidar les obligacions, per tant, no han estat valorades a valor actual ja que l'efecte financer del seu descompte no resulta significatiu.
a) Provision for consortium	a) Provisió consorcis
This provision records the existing risk, according to the City Council's share, in the consortium that present a negative net equity in their annual accounts.	Aquesta provisió recull, en funció de la participació de l'Ajuntament, el risc existent en aquells consorcis que presenten un patrimoni net negatiu en els seus comptes anuals.
The implementation of this provision in the financial year 2017 for the amount of €5,854,531.50 reflects the fact that the profit and loss corresponding to six consortia enabled their net equity to be rebalanced.	L'aplicació d'aquesta provisió en l'exercici 2017 per import de 5.854.531,50 euros correspon al fet que els resultats econòmics corresponents a sis consorcis han permès reequilibrar el seu patrimoni net.
b) Interest compliance TSJC judgement 632/2013	b) Interessos compliment sentència 632/2013 TSJC
The City Council's compliance with judgement 632/2013 of the Supreme Court of Justice of Catalonia, in the financial year 2016, meant it was forced to increase civil servants' salaries for 2017 and 2018.	A l'exercici 2016, l'Ajuntament va donar compliment a allò que disposava la sentència 632/2013 del Tribunal Superior de Justícia de Catalunya que obligava a incrementar la massa salarial dels funcionaris per als anys 2007 i 2008.
Judgement 528/2017 of 12 September 2017 upheld an appeal that recognised the	La sentència 528/2017 de 12 de setembre de 2017 va estimar un recurs d'apel·lació on es reconeixia el dret a percebre interessos per les quantitats abonades en virtut de la sentència 632/2013.
right to receive interest on the amounts paid by virtue of judgement 632/2013.	L'Ajuntament ha presentat recurs de cassació però, davant la possibilitat de no
The City Council has applied for a judicial review but, given the possibility of it not being admitted or of an unfavourable judgement, Human Resources have estimated that complying with such a judgement would cost €10 million.	admissió o de sentència desfavorable, la Gerència de Recursos Humans ha estimat que el compliment d'aquesta segona sentència tindria un cost estimat de 10 milions d'euros.
16.1. Contingent liabilities.	16.1. Passius contingents
Constitutional Court judgement (STC) 59/2017 of 11 May, declared unconstitutional and null and void articles 107.1, 107.2(a) and 110.4 of the Consolidated Text of the Local Tax Authorities Act (TRLRHL), approved by Royal Legislative Decree (RDL) 2/2004 of 5 March, inasmuch as they submit situations where there has been no increase in value to the tax on the increase in value of urban land.	
The judgement itself states that “determining the existence or not of an increase	La STC 59/2017 d'11 de maig, va declarar inconstitucionals i nuls els arts. 107.1,
liable to taxation is something that corresponds solely to the legislator with	107.2.a) i 110.4 del TRLHL, aprovat pel RDL 2/2004, de 5 de març, en la mesura en
its freedom to shape legislation following the publication of this judgement, implementing the pertinent modifications or adaptations to the legal framework	què sotmeten a tributació situacions d'inexistència d'increments de valor en relació a l'impost sobre l'increment de valor dels terrenys de naturalesa urbana.
of the tax that make it possible to arbitrate instances in which taxation situations	La pròpia sentència declara que “la forma de determinar la existencia o no
where there is no increase in the value of urban land are not submitted”.	de un incremento susceptible de ser sometido a tributación es algo que solo
Despite the time that has elapsed since the aforementioned judgement was issued, it was only on 9 March 2018 that it entered the Congress of Deputies following the publication in the Official Gazette of the Spanish Parliament (BOCG) of a Bill to	corresponde al legislador, en su libertad de configuración normativa, a partir de la publicación de esta Sentencia, llevando a cabo las modificaciones o adaptaciones pertinentes en el régimen legal del impuesto que permitan arbitrar el modo de no someter a tributación las situaciones de inexistencia de incremento de valor de los terrenos de naturaleza urbana”.
modify the Consolidated Text of the Local Tax Authorities Act, approved by RDL	No ha estat fins al passat 9 de març de 2018, malgrat el temps transcorregut des de l'esmentada sentència del TC, que ha entrat en el Congrés dels Diputats, mitjançant la publicació al Butlletí Oficial de les Corts Generals de la Proposició de Llei per la
2/2004 of 5 March, and other tax regulations, in order to bring the text of local tax authority legislation in line with the Constitutional Court's pronouncement.	que se modifica el text refós de la Llei reguladora de les hisendes locals, aprovat per RDL 2/2004, de 5 de març, i altres normes tributàries, als efectes d'adequar el text de la legislació d'hisendes locals al pronunciament de l'Alt Tribunal.
Given that no legislation had been passed when these annual accounts were drawn up, no provision has been recorded, as the amount cannot be reliably estimated until a valid text has been approved.	Donat què a la data de formulació d'aquests comptes anuals encara no s'ha
Likewise, at the close of the financial year, the City Council was in the middle of	aprovat cap llei , no s'ha registrat cap provisió atenent a què el seu import no pot
legal proceedings, described as being at possible risk, at the courts and tribunals.	ser valorat de forma fiable fins que no es disposi d'un text vàlidament aprovat .
One case that should be mentioned is a claim under the heading of financial	Així mateix, a la data de tancament de l'exercici, l'Ajuntament té assumptes
liability which originated from an order to cease activity being carried out by a	contenciosos en tramitació als jutjats i tribunals que es qualifiquen amb risc
company as it differed from the authorised activity.	possible, d'entre els quals cal fer esment a un assumpte on es reclama en concepte de responsabilitat patrimonial i que té el seu origen en un ordre de cessament de l'activitat desenvolupada per una empresa al portar a terme una activitat diferent a l'autoritzada.
There are three matters where there is a probable risk but it has not been possible to quantify the cost of the judgement in these cases. These matters relate to a works permit for the construction of two single-family dwellings and two works permits for the construction of two hotel establishments.	Existeixen tres assumptes amb risc probable però sobre els quals no ha estat possible dur a terme una quantificació del cost de la sentència. Aquests assumptes corresponen a una llicència d'obres per a la construcció de dos habitatges unifamiliars i a dues llicències d'obres per la construcció de dos establiments hotelers.
16.2. Contingent assets.	16.2. Actius contingents
At the close of the financial year, the City Council had no contingent assets	A la data de tancament de l'exercici, l'Ajuntament no té actius de naturalesa
regarding which information must be given in the annual report.	contingent dels que calgui informar en la memòria.
17. Information on the environment	17. Informació sobre el medi ambient
The City Council recorded the following obligations charged to the programmes of expenditure policy 17 “Environment”:	L'Ajuntament ha registrat les següents obligacions amb càrrec als programes de la política de despesa 17 “Medi ambient”:
18. Assets under sale	18. Actius en estat de venda
On the closing date, the City Council did not keep fixed assets in the balance sheet where the accounting value thereof had to be recovered through sale.	A la data de tancament, l'Ajuntament no manté en balanç actius no corrents el valor comptable dels quals hagi de recuperar-se a través de la seva venda.
19. Presentation of the income and expenditure account by activity	19. Presentació per activitats del compte del resultat econòmic-patrimonial
Barcelona City Council's Income and Expenditure Account, classed by activity, is as follows:	El compte de resultats econòmic patrimonial de l'Ajuntament de Barcelona classificat per activitats és com segueix:
The following rules have been taken into account for its drafting:	Per a la seva elaboració s'han tingut en compte les normes següents:
a) Income: classification of total income in the categories of day-to-day management income, financial and other income.	a) Ingressos: classificació dels ingressos totals en les categories d'ingressos de gestió ordinària, ingressos financers i altres ingressos.
b) Expenditure: the budgetary expenses set out in chapters 1 to 5 of the City	b) Despeses: les despeses pressupostàries recollides als capítols 1 a 5 del
Council's current expenditure budget, classed by expenditure policy. The other expenses in the Income and Expenditure Account, distributed among the various expenditure policies in the proportion that each policy represents of the total expenditure budget.	pressupost des despeses corrents de l'Ajuntament, classificades per política de despesa. La resta de despeses del compte de resultats econòmic patrimonial, distribuïdes en les diferents polítiques de despesa en la proporció que, sobre la despesa total pressupostària, suposa cada una de les polítiques de despesa.
20. Resource administration receivables on behalf of other public bodies	20. Operacions per administració de recursos per compte d'altres ens públics
The amount included in the assets side of the balance sheet refers to entitlements pending collection from third parties regarding the development of the resource administration management payable by other public bodies (Note 20.3 a).	El saldo inclòs a l'actiu del balanç fa referència als drets pendent de cobrar del
The amount included in the liabilities side of the balance sheet is that from Note	tercer en relació al desenvolupament de la gestió d'administració de recursos per
20.3 a) - as these entitlements, still pending, will have to be delivered to the	compte d'altres ens públics (nota 20.3 a).
organisation through which the administration is carried out - plus the balance	El saldo inclòs al passiu del balanç és l'import de la nota 20.3 a) -ja que aquests
of the amounts already collected from third parties but pending delivery to the	drets pendent de cobrar hauran de lliurar-se a l'ens pel qual es fa l'administració-
organisation through which the administration is made, and reflected in Note 20.1.	més el saldo dels imports ja recaptats del tercer però pendents de lliurar a l'ens pel qual es fa l'administració, i reflectits a la nota 20.1.
20.1. Management-derived debentures	20.1. Obligacions derivades de la gestió
20.2. Public bodies, current cash accounts	20.2. Ens públics, comptes corrents en efectiu
The City Council does not use such accounts as cash deliveries are not made to the final settlement account.	L'Ajuntament no utilitza aquests comptes ja que no es realitzen lliuraments d'efectiu a compte de la liquidació definitiva.
20.3. Management development	20.3. Desenvolupament de la gestió
a) Summary	a) Resum
b) Revoked collection rights	b) Drets anul·lats
c) Cancelled collection rights	c) Drets cancel·lats d) Devolució d'ingressos
21. Non-budgetary liquid asset transactions	21. Operacions no pressupostàries de tresoreria
Information is given below on the non-budgetary liquid asset transactions included in these transactions made over the financial year which led to the creation or extinction of:	A continuació s'informa sobre les operacions no pressupostàries de tresoreria que comprenen aquelles operacions realitzades durant l'exercici que han donat lloc al naixement o extinció de:
• Receivables and liabilities under the current rules for the City Council that do not have to be allocated to its budget either at the time of their creation or maturity.	• Deutors i creditors que, d'acord amb la normativa vigent per a l'Ajuntament, no s'hagin d'imputar al seu pressupost, ni en el moment del seu naixement ni en el del seu venciment.
• Items representing collections and payments pending final application, for both budgetary and non-budgetary transactions.	• Partides representatives de cobraments i pagaments pendents d'aplicació definitiva, tant per operacions pressupostàries com no pressupostàries.
21.1. Non-budgetary receivables statement.	21.1. Estat de deutors no pressupostaris
21.2. Non-budgetary liabilities statement	21.2. Estat de creditors no pressupostaris
21.3. Statement of items pending application a) Collections pending application	21.3. Estat de partides pendents d'aplicació a) Cobraments pendents d'aplicació
b) Payments pending application	b) Pagaments pendents d'aplicació
At the close of the financial year, the City Council had no payments pending application.	Al tancament de l'exercici l'Ajuntament no té pagaments pendents d'aplicació.
22. Administrative procurement. Awarding procedures	22. Contractació administrativa. Procediments d'adjudicació
The aggregate amounts of administrative procurement during the financial year, according to the awarding procedure, are shown below.	A continuació es detallen els imports agregats de les contractacions administratives realitzades en l'exercici en funció del seu procediment d'adjudicació.
23. Securities received on deposit	23. Valors rebuts en dipòsit
24. Budget information	24. Informació pressupostària
24.1. Current financial year	24.1. Exercici corrent
24.1.1. Expenditure budget a) Credit amendments	24.1.1. Pressupost de despeses a) Modificacions de crèdit
b) Credit surpluses	b) Romanents de crèdit
c) Liabilities for transactions pending application to the budget	c) Creditors per operacions pendents d'aplicar al pressupost
The City Council does not have any payable transactions yet to be applied to the budget.	L'Ajuntament no té operacions creditores pendents d'aplicar al pressupost.
24.1.2. Income budget	24.1.2. Pressupost d'ingressos
a) Management process a1) Revoked collection rights	a) Procés de gestió a1) Drets anul·lats
a2) Revoked collection rights	a2) Drets cancel·lats
a3) Net collection	a3) Recaptació neta
b) Returned income	b) Devolucions d'ingressos
c) Committed income	c) Compromisos d'ingrés
24.2. Closed financial years	24.2. Exercicis tancats
24.2.1. Expenditure budget Closed budget debentures	24.2.1. Pressupost de despeses. Obligacions de pressupostos tancats
24.2.2. Income budget. Entitlements pending collection from closed budgets a) Total entitlements pending collection	24.2.2. Pressupost d'ingressos. Drets a cobrar de pressupostos tancats a) Drets pendents de cobrament totals
b) Revoked collection rights	b) Drets anul·lats
c) Cancelled collection rights	b) Drets cancel·lats
24.2.3. Variation of results	24.2.3. Variació de resultats
24.3. Subsequent financial years	24.3. Exercicis posteriors
24.3.1. Committed expenditure charged to budgets of subsequent financial years	24.3.1. Compromisos de despesa amb càrrec a pressupostos d'exercicis posteriors
24.3.2. Committed income charged to budgets of subsequent financial years	24.3.2. Compromisos d'ingrés amb càrrec a pressupostos d'exercicis posteriors
24.4. Expenditure with allocated funding	24.4. Despeses amb finançament afectat
24.5. Treasury surplus	24.5. Romanent de tresoreria
The treasury surplus statement resulting from the financial year budget settlement and those of previous financial years is as follows:	L'estat del romanent de tresoreria que resulta de la liquidació del pressupost de l'exercici i de pressupostos d'exercicis anteriors és el següent:
25. Financial, equity and budget indicators	25. Indicadors financers, patrimonials i pressupostaris
a) Financial and equity indicators	a) Indicadors financers i patrimonials
• Immediate liquidity:	• Liquiditat immediata:
Liquid funds	Fons líquids
= 0.88	= 0,88
Current habilities	Passiu corrent
• Short-term liquidity:	• Liquiditat a curt termini:
Liquid funds + Entitlements pending collection	Fons líquids+ Drets pendents de cobrament
--------------------------------------------------= 1.61	------------------------------------------- = 1,61
Current liabilities	Passiu corrent
• General liquidity:	• Liquiditat general:
Current assets	Actiu corrent
= 1.10	= 1,10
Current liabilities	Passiu corrent
• Debt per resident:	• Endeutament per habitant:
Liabilities	Passiu
----------------------= 1,480.51 euros	------------------- = 1.480,51 euros
Number of residents	Nombre d'habitants
• Debt:	• Endeutament:
Liabilities	Passiu
= 0.17	= 0,17
Liabilities + Net equity	Passiu + Patrimoni net
• Debt ratio:	• Relació d'endeutament:
Current liabilities	Passiu corrent
= 0.65	= 0,65
Fixed liabilities	Passiu no corrent
• Cash flow:	• Flux de caixa:
Liabilities	Passiu
= 6.58	= 6,58
Net management flows	Fluxos nets de gestió
• Average payment period to commercial liabilities: 28.5 days. • Average collection period: 26.9 days.	• Període mig de pagament a creditors comercials: 28,5 dies. • Període mig de cobrament: 26,9 dies.
• Income and Expenditure Account ratios	• Ràtios del compte del resultat econòmic-patrimonial
• Income structure	Estructura dels ingressos
• Expenditure structure	• Estructura de les despeses
• Coverage of current expenses: highlights the existing relationship between day-to-day management expenditure and income.	• Cobertura de les despeses corrents: posa de manifest la relació existent entre les despeses de gestió ordinària i els ingressos de la mateixa naturalesa.
Day to day management expenses	Despeses de gestió ordinària
= 90.27%	= 90,27%
Day to day management income	Ingressos de gestió ordinària
b) Budget indicators	b) Indicadors pressupostaris
For the current expenditure budget:	Del pressupost de despeses corrent:
• Implementation of the expenditure budget:	• Execució del pressupost de despeses:
Recognised net debentures	Obligacions reconegudes netes
------------------------ = 96.58%	------------------------------ = 96,58%
Final credits	Crèdits definitius
• Payments made:	• Realització de pagaments:
Payments made	Pagaments efectuats
------------------------ = 78.71%	------------------------------ = 78,71%
Recognised net debentures	Obligacions reconegudes netes
• Expenditure per resident:	• Despesa per habitant:
Recognised net debetures	Obligacions reconegudes netes
------------------------= 1,648.61 euros	------------------------------ = 1.648,61 euros
Number of residents	Nombre d'habitants
• Investment per resident:	• Inversió per habitant:
Recognised net debentures (Chapters 6 and 7)	Obligacions reconegudes netes (capítols 6 i 7)
------------------------------------------- = 260.74 euros	-------------------------------------------- = 260,74 euros
Number of residents	Nombre d'habitants
• Investment effort:	• Esforç inversor:
Recongised net debentures (Chapters 6 and 7)	Obligacions reconegudes netes (capítols 6 i 7)
------------------------------------------ = 15.82%	-------------------------------------------- = 15,82%
Total recognised net debentures	Total obligacions reconegudes netes
For the current income budget:	Del pressupost d'ingressos corrent:
• Implementation of the income budget:	• Execució del pressupost d'ingressos:
Net recognised collectin rights	Drets reconeguts nets
= 97.86%	= 97,86%
Final forecast	Previsions definitives
• Collection made:	• Realització de cobraments:
Net collection	Recaptació neta
-----------------------------= 95.48%	--------------------- = 95,48%
Net recognised collection rights	Drets reconeguts nets
• Autonomy:	• Autonomia:
Recognised net collection rights (Chapters 1 and 3, 5, 6, 8 + transfers received)	Drets reconeguts nets (capítols 1 a 3, 5, 6, 8 + transferències rebudes)
--------------------------------------------------------------------= 95.21%	----------------------------------------------------------------- = 95,21%
All recognised net collection rights	Total drets reconeguts nets
• Tax autonomy:	• Autonomia fiscal:
Recognised net collection rights (Chapter 1 to 3)	Drets reconeguts nets (capítols 1 a 3)
--------------------------------------------- = 53.22%	----------------------------------- = 53,22%
All recognised net collection rights	Total drets reconeguts nets
• Surplus (deficit) per resident:	• Superàvit (o dèficit per habitant):
Adjusted budget result	Resultat pressupostari ajustat
---------------------= 17.65 euros	---------------------------- = 17,65 euros
Number of residents	Nombre d'habitants
For closed budgets:	De pressupostos tancats:
• Payments made:	• Realització de pagaments:
Payments	Pagaments
--------------------------------------------------------- = 79.52%	----------------------------------------------------= 79,52%
Initial balance for debentures (± amendments and annulments)	Saldo inicial d'obligacions (± modificacions i anul·lacions)
• Collections made:	• Realització de cobraments:
Collection	Cobraments
--------------------------------------------------------- = 20.21%	--------------------------------------------- =20,21%
Initial balance for debentures (± amendments and annulments)	Saldo inicial drets (± modificacions i anul·lacions)
26. Information on the costs of activities	26. Informació sobre el cost de les activitats
The results provided in this and the following sections supplement the information on the cost of activities and management indicators established in Order HAP/1781/2013, the guidelines for the usual model of public accounting in the sense of at least presenting by services and activities financed by public taxes and charges.	Els resultats facilitats en aquest apartat i el següent dona compliment a la informació sobre el cost de les activitats i indicadors de gestió establerts en l'ordre HAP/1781/2013, instrucció del model normal de comptabilitat pública en el sentit de presentar almenys pels serveis i activitats finançades amb taxes i preus públics.
With regard to these amounts, it should be pointed out that they are a selection of the results from the Barcelona City Council cost model, based on the ABC (Activity Based Costing) model, in which only those activities/tasks financed by public taxes or charges have been considered.	En relació a aquests imports cal remarcar que son un extracte dels resultats del model de costos de l'Ajuntament de Barcelona, basat en el model de costos ABC (Activity Based Costing) en el que s'han considerat únicament aquelles activitats-tasques que tenen en el seu finançament via taxes o preus públics.
General summary of city council costs	Resum general de costos de l'ajuntament
COST SUMMARY PER ITEM OF ACTIVITY	Resum general de costos de l'ajuntament
Cultural and outreach activities: Courses and workshops	Activitats culturals i de divulgació: Cursos i tallers
Cultural and outreach activities: Renting and use of premises	Activitats culturals i de divulgació: Lloguer i cessió d'espais
Training activities: Courses and workshops	Activitats formatives: Cursos i tallers
Urban planning activities: Subsidiary implementation files	Actuació urbanística: Expedients d'execució subsidiària
Urban planning activities: Urban planning files and reports	Actuació urbanística: Expedients i informes urbanístics
Urban planning activities: Processing major works permits	Actuació urbanística: Tramitació de les llicències d'obra major
Actions: Fountains	Actuacions: Fonts
Animals: Protection and control of animals: Barcelona Pet Shelter (CAACB)	Animals: Protecció i control d'animals: Centre d'Acollida d'Animals de Companyia de Barcelona (CAACB)
Advice and Training: External training for fire-fighters	Assessoraments i Formació: Formació externa donada pels bombers
Cost summary per activity	Resum dels costos per activitat
Summary relating activity costs and income from activity	Resum relacionant costos i ingressos de les activitats
27. Management indicators	27. Indicadors de gestió
As pointed out in note 26, only those indicators that refer to services and activities financed with taxes and public charges are shown.	Tal i com s'indica a la nota 26 es presenten únicament els indicadors que fan referència als serveis i activitats finançades amb taxes i preus públics.
Likewise, it should be noted that systems and procedures are currently being adapted that will enable us to define all the economic, efficiency and effectiveness indicators set out in the current Guidelines.	Així mateix cal indicar que en l'actualitat s'estan adaptant els sistemes i definint els procediments per poder determinar tots els indicadors d'eficàcia, eficiència i economia, i de mitjans de producció que estableix la vigent Instrucció.
Urban planning activities: Subsidiary implementation files	Actuació urbanística: Expedients d'execució subsidiària
€ 751,033.06	751.033,06 €
= € 11,554.35 / file	= 11.554,35 € / expedient
65 files	65 expedients
Urban planning activities: Urban planning files and reports	Actuació urbanística: Expedients i informes urbanístics
€ 1,272,960.47	1.272.960,47 €
= € 897.08 / file	= 897,08 € / expedient
1,419 files s	1.419 expedients
Urban planning activities: Processing major works licences	Actuació urbanística: Tramitació de las llicències d'obra major
€ 1,732,938.19	1.732.938,19 €
= € 1,245.82 / license	= 1.245,82 € / llicència
1,391 licenses	1.391 llicències
Advice and Training: External training for fire-fighters	Assessorament i Formació: Formació externa donada pels bombers
€ 132,544.50	132.544,50 €
-------------------= € 152.00 / student	= 152,00 € / alumne
872 students	872 alumnes
Family and children: Activities and coordination of children's centres, youth centres and toy libraries	Família i infància: Activitats i coordinació dels centres infantils, espais adolescents i ludoteques infantils
€ 5,234,531.56	5.234.531,56 €
--------------------------- = € 03.23 / city inhabitant	--------------------------- = 03,23 € / habitant ciutat
1,620,809 city inhabitants	1.620.809 habitants ciutats
Family and children: Promoting childhood and adolescence	Família i infància: Promoció de la infància i l'adolescència
€ 506,933.48	506.933,48 €
----------------------------------------= € 580.02 / child or adolescent	------------------------------= 580,02 € / nen o adolescent
874 children and adolescents attended tos	874 nens i adolescents atesos
Senior citizens: Activities and coordination of municipal senior citizen centres and spaces	Gent gran: Activitats i coordinació dels casals i espais municipals per a gent gran
€ 7,680,875.79	7.680.875,79 €
= € 144,922.18 / centre	= 144.922,18 € / casal
53 centres	53 casals
Youth: Activities and coordination of youth centres and Youth Information Points (PIJ)	Joventut: Activitats i coordinació dels centres de joves i Punts d'Informació Juvenil (PIJ)
€ 4,257,129.49	4.257.129,49 €
= € 152,040.34 / centre	= 152.040,34 € / casal
28 centre	28 casals
Public highway licences: Inspections of activities in public areas	Llicències a la via pública: Inspeccions d'activitats en l'espai públic
€ 5,798,434.06	5.798.434,06 €
= € 224.34 / inspection	= 224,34 € / inspecció
25,847 inspections	25.847 inspeccions
Public highway licences: Minor construction work licences	Llicències a la via pública: Llicències d'obra menor
€ 1,506,596.41	1.506.596,41 €
------------------= € 32.91 / licence	------------------- = 32,91 € / llicència
45,778 licences	45.778 llicències
Public highway licences: Licences for commercial occupancy of pavements and public spaces	Llicències a la via pública: Llicències d'ocupació comercial de voreres i espais d'ús públic
€ 1,852,765.01	1.852.765,01 €
= € 76.07 / licence	------------------- = 76,07 € / llicència
24,356 licences	24.356 llicències
Waste collection and management: Green points for waste treatment and selection (TERSA)	Recollida i gestió de residus: Punts verds per tractament i selecció de residus (TERSA)
€ 4,803,381.26	4.803.381,26 €
------------------------------ = € 285.42 / tonne collected	------------------------------------= 285,42 € / tona recollida
16,829 tonnes collected	16.829 número de tones recollides
Waste collection and management: Old furniture and junk collection	Recollida i gestió de residus: Recollida de mobles i trastos vells
€ 12,351,999.77	12.351.999,77 €
--------------------------------------------= € 353.87 / tonne of furniture and junk	-------------------------------------= 353,87 € / tona de mobles i andròmines
34,905 tonnes of furniture and pieces of junks	34.905 tones de mobles i andròmines
Waste collection and management: Domestic waste collection	Recollida i gestió de residus: Recollida domiciliària d'escombraries
€ 67,228,768.13	67.228.768,13 €
---------------------------= € 41.48 / city inhabitant	---------------------------= 41,48 € / habitant ciutat
1,620,809 city inhabitants	1.620.809 habitants ciutats
Waste collection and management: Commercial waste	Recollida i gestió de residus: Residus comerços
€ 17,010,141.91	17.010.141,91 €
----------------------------------= € 316.41 / tonne commercial waste	------------------------------------= 316,41 € / tona d'origen comercial
53,760 tonnes commercial waste	53.760 tones d'origen comercial
Waste collection and management: Municipal market waste	Recollida i gestió de residus: Residus mercats municipals
€ 3,178,507.17	3.178.507,17 €
-----------------------= € 255.73 / tonne collected	------------------------= 255,73 € / tona recollida
12,429 tonnes collected	12.429 tones recollides
District procedures: Activity licences	Tràmits dels districtes: Llicències d'activitats
€ 1,639,375.34	1.639.375,34 €
--------------= € 6,117.07 / revision	----------------= 6.117,07 € / revisió
268 revisions	268 revisions
28. Events subsequent to accounts closure	28. Fets posteriors al tancament
No significant events occurred between closure and drafting of the annual accounts which would require reporting or lead to the inclusion of adjustments to the figures contained in the annual accounts.	Entre la data de tancament de l'exercici i la de formulació dels comptes anuals no s'han produït fets significatius que hagin d'informar-se o què hagin de donar lloc a la incorporació d'ajustaments en les xifres contingudes en els comptes anuals.
29. Other information	29. Altra informació
a) Accrued liabilities expenditure	a) Ajustaments per periodificació de passiu
The long-term variations in the accrued liabilities expenditure item for the 2017 financial year were as follows:	El moviment de l'epígraf d'ajustaments per periodificació a llarg termini a l'exercici 2017 ha estat el següent:
The balance on 31 December 2017 corresponds to income received in advance for the right to use municipally owned assets. Income received in advance is transferred every year to the Profit and Loss Account using the straight-line method for the duration of the period of the corresponding concession, which will end, at the latest, by 2092.	El saldo a 31 de desembre de 2017 correspon a ingressos rebuts per avançat pel dret d'utilització de béns de titularitat municipal. Els ingressos rebuts per avançat es traspassen anualment al compte de resultats de manera lineal en el decurs del període de la corresponent concessió, que es situa com a màxim a l'any 2092.
Short-term accrued expenditure for the 2017 financial year presents the following variations:	Els ajustaments per periodificació a curt termini a l'exercici 2017 presenten el següent moviment:
b) Auditors' fees	b) Honoraris dels auditors
The fees to be received by Ernst & Young, SL, corresponding to the audit services and expenditure incurred in the provision of these services during the 2017 financial year amounted to €120,000, VAT included. Invoiced to Barcelona City Council under the audit contract's invitation-to-tender lot 1 file, these fees also included the audit work of the consolidated annual accounts of the Barcelona City Council group, quality control and coordination of the work and support for the General Intervention in exercising financial control over fifteen grants and subsidies.	Els honoraris a percebre per Ernst & Young, SL, corresponents als serveis d'auditoria i despeses incorregudes per la prestació d'aquests serveis de l'exercici 2017 ascendeixen a 120 milers d'euros, IVA inclòs. Aquests honoraris, que es facturen a l'Ajuntament de Barcelona en virtut de l'expedient d'adjudicació del lot 1 del concurs d'auditoria, inclouen també els treballs d'auditoria dels comptes anuals consolidats del grup Ajuntament de Barcelona, control de qualitat i coordinació dels treballs i suport a la Intervenció General en l'exercici del control financer respecte de quinze subvencions.
c) Taxes and social security contributions subject to inspection	c) Impostos i cotitzacions socials susceptibles d'inspecció
All taxes and social security contributions that the City Council is subject to are eligible for auditing for all the financial years during which the limitation period deadline established under the legislation in force has not lapsed. No additional liabilities that merit consideration are expected for the City Council as a result of possible inspections.	Són susceptibles d'actuació inspectora tots els tributs i cotitzacions socials a què es troba subjecte l'Ajuntament per a tots els exercicis que no hagi transcorregut el termini de prescripció que estableix la normativa vigent. No s'espera que es meritin passius addicionals de consideració per a l'Ajuntament com a conseqüència d'eventuals actuacions inspectores.
The Chief Executive of Barcelona City Council, on 23 May 2018, acting in compliance with the requirements established by Article 64 of Act 1/2006 regulating the special system for Barcelona, hereby draws up the consolidated annual accounts in this document, pages 1 to 84, corresponding to the financial year ending 31 December 2017.	El Gerent Municipal de l'Ajuntament de Barcelona, en data 23 de maig de 2018, i en compliment dels requisits establerts a l'article 64 de la llei 1/2006 que regula el règim especial de Barcelona, procedeix a formular els comptes anuals compresos en aquest document, de les pàgines 1 a 84, corresponents a l'exercici anual acabat a 31 de desembre de 2017.
The Municipal Chief Executive	El gerent municipal
